Orthogroup	aip_longest_isoforms	nvec_longest_isoform	spis_longest_isoform_marker	xenia_longest_isoforms	Total
OG0000000	0	0	1	158	159
OG0000001	0	0	0	137	137
OG0000002	1	0	1	121	123
OG0000003	0	0	1	112	113
OG0000004	0	0	108	0	108
OG0000005	0	0	1	107	108
OG0000006	1	3	6	95	105
OG0000007	2	1	101	0	104
OG0000008	0	0	0	94	94
OG0000009	0	0	1	88	89
OG0000010	0	0	0	84	84
OG0000011	1	0	1	78	80
OG0000012	4	1	75	0	80
OG0000013	0	0	4	73	77
OG0000014	0	0	0	77	77
OG0000015	19	5	13	37	74
OG0000016	0	0	0	71	71
OG0000017	0	0	0	70	70
OG0000018	4	2	38	25	69
OG0000019	0	0	68	0	68
OG0000020	0	0	66	1	67
OG0000021	0	0	0	67	67
OG0000022	0	0	0	67	67
OG0000023	0	1	65	0	66
OG0000024	65	0	0	0	65
OG0000025	0	0	0	64	64
OG0000026	0	0	63	0	63
OG0000027	0	0	0	63	63
OG0000028	18	21	20	0	59
OG0000029	0	0	54	5	59
OG0000030	0	0	0	59	59
OG0000031	1	1	1	55	58
OG0000032	0	0	0	58	58
OG0000033	0	0	0	57	57
OG0000034	0	0	1	55	56
OG0000035	3	2	0	49	54
OG0000036	0	0	0	53	53
OG0000037	0	0	0	52	52
OG0000038	47	0	3	1	51
OG0000039	4	3	4	40	51
OG0000040	47	1	2	0	50
OG0000041	0	50	0	0	50
OG0000042	0	0	0	50	50
OG0000043	48	1	0	0	49
OG0000044	22	0	25	1	48
OG0000045	0	0	48	0	48
OG0000046	46	0	0	0	46
OG0000047	1	0	0	45	46
OG0000048	1	1	1	43	46
OG0000049	0	0	0	46	46
OG0000050	0	0	0	46	46
OG0000051	0	0	0	45	45
OG0000052	44	0	0	0	44
OG0000053	1	1	1	41	44
OG0000054	6	0	3	35	44
OG0000055	0	0	0	44	44
OG0000056	0	0	0	44	44
OG0000057	5	0	38	0	43
OG0000058	1	1	41	0	43
OG0000059	0	1	41	1	43
OG0000060	42	0	0	0	42
OG0000061	1	0	0	41	42
OG0000062	0	0	0	42	42
OG0000063	0	0	0	42	42
OG0000064	13	4	6	18	41
OG0000065	0	0	0	41	41
OG0000066	0	0	0	41	41
OG0000067	40	0	0	0	40
OG0000068	40	0	0	0	40
OG0000069	14	0	4	22	40
OG0000070	0	0	0	40	40
OG0000071	0	0	0	40	40
OG0000072	6	2	27	4	39
OG0000073	1	2	1	35	39
OG0000074	1	0	1	37	39
OG0000075	0	0	39	0	39
OG0000076	0	0	39	0	39
OG0000077	0	0	0	39	39
OG0000078	14	8	16	0	38
OG0000079	31	0	6	1	38
OG0000080	9	25	1	3	38
OG0000081	1	1	2	34	38
OG0000082	4	0	27	7	38
OG0000083	1	0	37	0	38
OG0000084	0	0	0	38	38
OG0000085	11	13	10	3	37
OG0000086	1	36	0	0	37
OG0000087	0	0	0	37	37
OG0000088	12	4	10	10	36
OG0000089	16	10	7	3	36
OG0000090	10	17	8	1	36
OG0000091	0	0	36	0	36
OG0000092	0	0	0	36	36
OG0000093	0	0	0	36	36
OG0000094	11	5	15	4	35
OG0000095	15	5	12	3	35
OG0000096	1	33	1	0	35
OG0000097	10	10	14	1	35
OG0000098	0	0	0	35	35
OG0000099	0	0	0	35	35
OG0000100	0	0	0	35	35
OG0000101	0	0	0	35	35
OG0000102	3	26	3	2	34
OG0000103	1	2	31	0	34
OG0000104	1	1	3	29	34
OG0000105	0	0	31	3	34
OG0000106	3	29	1	0	33
OG0000107	0	33	0	0	33
OG0000108	0	0	33	0	33
OG0000109	0	0	33	0	33
OG0000110	0	0	0	33	33
OG0000111	0	0	0	33	33
OG0000112	32	0	0	0	32
OG0000113	25	6	1	0	32
OG0000114	21	4	6	1	32
OG0000115	14	2	15	1	32
OG0000116	0	30	0	2	32
OG0000117	0	1	31	0	32
OG0000118	0	0	32	0	32
OG0000119	0	0	0	32	32
OG0000120	0	0	0	32	32
OG0000121	0	0	0	32	32
OG0000122	0	0	0	32	32
OG0000123	0	0	0	32	32
OG0000124	31	0	0	0	31
OG0000125	1	0	0	30	31
OG0000126	0	31	0	0	31
OG0000127	0	3	26	2	31
OG0000128	0	0	31	0	31
OG0000129	0	0	31	0	31
OG0000130	0	0	0	31	31
OG0000131	0	0	0	31	31
OG0000132	0	0	0	31	31
OG0000133	0	0	0	31	31
OG0000134	26	1	3	0	30
OG0000135	1	2	27	0	30
OG0000136	29	1	0	0	30
OG0000137	27	1	2	0	30
OG0000138	27	2	0	1	30
OG0000139	1	0	25	4	30
OG0000140	2	4	2	22	30
OG0000141	1	0	1	28	30
OG0000142	0	1	0	29	30
OG0000143	0	0	30	0	30
OG0000144	0	0	30	0	30
OG0000145	0	0	30	0	30
OG0000146	0	0	0	30	30
OG0000147	0	0	0	30	30
OG0000148	0	0	0	30	30
OG0000149	0	0	0	30	30
OG0000150	15	5	7	2	29
OG0000151	1	0	26	2	29
OG0000152	5	2	4	18	29
OG0000153	29	0	0	0	29
OG0000154	1	0	28	0	29
OG0000155	2	0	5	22	29
OG0000156	1	0	0	28	29
OG0000157	0	0	0	29	29
OG0000158	0	0	0	29	29
OG0000159	0	0	0	29	29
OG0000160	0	0	0	29	29
OG0000161	0	0	0	29	29
OG0000162	3	6	7	12	28
OG0000163	9	8	10	1	28
OG0000164	8	7	7	6	28
OG0000165	12	5	9	2	28
OG0000166	1	0	1	26	28
OG0000167	10	1	7	10	28
OG0000168	4	0	23	1	28
OG0000169	2	0	1	25	28
OG0000170	0	4	23	1	28
OG0000171	0	0	28	0	28
OG0000172	0	0	0	28	28
OG0000173	0	0	0	28	28
OG0000174	3	12	11	1	27
OG0000175	26	1	0	0	27
OG0000176	27	0	0	0	27
OG0000177	0	0	27	0	27
OG0000178	0	0	1	26	27
OG0000179	0	0	0	27	27
OG0000180	0	0	0	27	27
OG0000181	11	8	6	1	26
OG0000182	7	5	13	1	26
OG0000183	4	1	20	1	26
OG0000184	24	0	1	1	26
OG0000185	4	3	18	1	26
OG0000186	0	1	0	25	26
OG0000187	0	1	25	0	26
OG0000188	0	1	0	25	26
OG0000189	0	0	26	0	26
OG0000190	0	0	1	25	26
OG0000191	0	0	0	26	26
OG0000192	0	0	0	26	26
OG0000193	0	0	0	26	26
OG0000194	0	0	0	26	26
OG0000195	11	13	0	1	25
OG0000196	1	1	7	16	25
OG0000197	25	0	0	0	25
OG0000198	1	1	2	21	25
OG0000199	1	1	1	22	25
OG0000200	1	0	0	24	25
OG0000201	1	0	24	0	25
OG0000202	1	2	20	2	25
OG0000203	0	2	0	23	25
OG0000204	0	0	24	1	25
OG0000205	0	0	25	0	25
OG0000206	0	0	0	25	25
OG0000207	0	0	0	25	25
OG0000208	0	0	0	25	25
OG0000209	0	0	0	25	25
OG0000210	0	0	0	25	25
OG0000211	0	0	0	25	25
OG0000212	0	0	0	25	25
OG0000213	0	0	0	25	25
OG0000214	24	0	0	0	24
OG0000215	14	0	6	4	24
OG0000216	6	7	8	3	24
OG0000217	10	1	5	8	24
OG0000218	24	0	0	0	24
OG0000219	1	1	1	21	24
OG0000220	24	0	0	0	24
OG0000221	3	0	0	21	24
OG0000222	2	4	12	6	24
OG0000223	1	23	0	0	24
OG0000224	14	3	5	2	24
OG0000225	1	1	1	21	24
OG0000226	1	1	1	21	24
OG0000227	0	24	0	0	24
OG0000228	0	0	24	0	24
OG0000229	0	0	0	24	24
OG0000230	0	0	0	24	24
OG0000231	0	0	0	24	24
OG0000232	0	0	0	24	24
OG0000233	0	0	0	24	24
OG0000234	5	0	17	1	23
OG0000235	12	3	7	1	23
OG0000236	5	7	10	1	23
OG0000237	23	0	0	0	23
OG0000238	2	2	2	17	23
OG0000239	8	6	5	4	23
OG0000240	4	8	11	0	23
OG0000241	1	3	16	3	23
OG0000242	2	1	1	19	23
OG0000243	1	0	0	22	23
OG0000244	2	1	2	18	23
OG0000245	2	0	2	19	23
OG0000246	0	1	0	22	23
OG0000247	0	2	0	21	23
OG0000248	0	0	22	1	23
OG0000249	0	0	23	0	23
OG0000250	0	0	1	22	23
OG0000251	0	0	0	23	23
OG0000252	0	0	0	23	23
OG0000253	0	0	0	23	23
OG0000254	0	0	0	23	23
OG0000255	22	0	0	0	22
OG0000256	7	8	6	1	22
OG0000257	10	10	1	1	22
OG0000258	21	0	1	0	22
OG0000259	9	2	11	0	22
OG0000260	7	2	4	9	22
OG0000261	5	3	8	6	22
OG0000262	3	3	15	1	22
OG0000263	3	3	2	14	22
OG0000264	2	15	5	0	22
OG0000265	4	7	8	3	22
OG0000266	4	2	3	13	22
OG0000267	1	21	0	0	22
OG0000268	0	2	0	20	22
OG0000269	0	0	0	22	22
OG0000270	0	0	0	22	22
OG0000271	0	0	0	22	22
OG0000272	0	0	0	22	22
OG0000273	6	8	6	1	21
OG0000274	11	4	5	1	21
OG0000275	1	0	20	0	21
OG0000276	8	8	3	2	21
OG0000277	10	5	5	1	21
OG0000278	1	4	15	1	21
OG0000279	1	1	16	3	21
OG0000280	2	11	7	1	21
OG0000281	2	3	1	15	21
OG0000282	1	1	1	18	21
OG0000283	0	21	0	0	21
OG0000284	0	0	0	21	21
OG0000285	0	0	0	21	21
OG0000286	0	0	0	21	21
OG0000287	0	0	0	21	21
OG0000288	0	0	0	21	21
OG0000289	0	0	0	21	21
OG0000290	0	0	0	21	21
OG0000291	18	2	0	0	20
OG0000292	16	4	0	0	20
OG0000293	20	0	0	0	20
OG0000294	6	5	4	5	20
OG0000295	20	0	0	0	20
OG0000296	15	0	0	5	20
OG0000297	15	0	5	0	20
OG0000298	6	0	10	4	20
OG0000299	7	3	6	4	20
OG0000300	7	1	1	11	20
OG0000301	4	3	4	9	20
OG0000302	1	3	2	14	20
OG0000303	10	5	4	1	20
OG0000304	5	3	2	10	20
OG0000305	3	4	13	0	20
OG0000306	3	5	12	0	20
OG0000307	3	0	3	14	20
OG0000308	1	0	19	0	20
OG0000309	1	0	0	19	20
OG0000310	0	20	0	0	20
OG0000311	0	20	0	0	20
OG0000312	0	16	4	0	20
OG0000313	0	0	20	0	20
OG0000314	0	0	20	0	20
OG0000315	0	0	20	0	20
OG0000316	0	0	1	19	20
OG0000317	0	0	1	19	20
OG0000318	0	0	0	20	20
OG0000319	0	0	0	20	20
OG0000320	0	0	0	20	20
OG0000321	0	0	0	20	20
OG0000322	0	0	0	20	20
OG0000323	0	0	0	20	20
OG0000324	0	0	0	20	20
OG0000325	15	2	2	0	19
OG0000326	3	2	6	8	19
OG0000327	8	0	2	9	19
OG0000328	19	0	0	0	19
OG0000329	7	9	2	1	19
OG0000330	19	0	0	0	19
OG0000331	4	3	11	1	19
OG0000332	19	0	0	0	19
OG0000333	7	3	7	2	19
OG0000334	3	9	5	2	19
OG0000335	5	0	11	3	19
OG0000336	14	3	1	1	19
OG0000337	4	3	11	1	19
OG0000338	16	2	1	0	19
OG0000339	1	0	0	18	19
OG0000340	2	0	0	17	19
OG0000341	16	0	2	1	19
OG0000342	2	5	11	1	19
OG0000343	1	0	1	17	19
OG0000344	0	19	0	0	19
OG0000345	0	19	0	0	19
OG0000346	0	18	1	0	19
OG0000347	0	1	3	15	19
OG0000348	0	0	19	0	19
OG0000349	0	0	19	0	19
OG0000350	0	0	1	18	19
OG0000351	0	0	1	18	19
OG0000352	0	0	0	19	19
OG0000353	0	0	0	19	19
OG0000354	13	5	0	0	18
OG0000355	6	3	8	1	18
OG0000356	6	3	7	2	18
OG0000357	1	2	10	5	18
OG0000358	11	0	6	1	18
OG0000359	6	5	4	3	18
OG0000360	2	16	0	0	18
OG0000361	5	5	6	2	18
OG0000362	8	2	7	1	18
OG0000363	5	1	11	1	18
OG0000364	2	3	12	1	18
OG0000365	4	6	5	3	18
OG0000366	8	1	6	3	18
OG0000367	2	1	11	4	18
OG0000368	18	0	0	0	18
OG0000369	17	1	0	0	18
OG0000370	3	4	10	1	18
OG0000371	11	0	6	1	18
OG0000372	3	1	7	7	18
OG0000373	1	5	5	7	18
OG0000374	3	8	7	0	18
OG0000375	3	5	2	8	18
OG0000376	1	1	1	15	18
OG0000377	1	0	17	0	18
OG0000378	1	0	0	17	18
OG0000379	2	3	11	2	18
OG0000380	2	1	14	1	18
OG0000381	1	1	1	15	18
OG0000382	0	0	10	8	18
OG0000383	0	0	18	0	18
OG0000384	0	0	1	17	18
OG0000385	0	0	18	0	18
OG0000386	0	0	17	1	18
OG0000387	0	0	1	17	18
OG0000388	0	0	1	17	18
OG0000389	0	0	18	0	18
OG0000390	0	0	0	18	18
OG0000391	0	0	0	18	18
OG0000392	0	0	0	18	18
OG0000393	0	0	0	18	18
OG0000394	0	0	0	18	18
OG0000395	0	0	0	18	18
OG0000396	0	0	0	18	18
OG0000397	0	0	0	18	18
OG0000398	0	0	0	18	18
OG0000399	0	0	0	18	18
OG0000400	0	0	0	18	18
OG0000401	0	0	0	18	18
OG0000402	7	5	3	2	17
OG0000403	6	3	6	2	17
OG0000404	2	7	6	2	17
OG0000405	12	1	4	0	17
OG0000406	11	1	5	0	17
OG0000407	4	4	8	1	17
OG0000408	3	2	3	9	17
OG0000409	3	0	10	4	17
OG0000410	14	2	0	1	17
OG0000411	17	0	0	0	17
OG0000412	1	0	16	0	17
OG0000413	10	1	5	1	17
OG0000414	2	1	1	13	17
OG0000415	17	0	0	0	17
OG0000416	15	2	0	0	17
OG0000417	5	4	8	0	17
OG0000418	6	1	3	7	17
OG0000419	4	0	13	0	17
OG0000420	1	1	8	7	17
OG0000421	4	3	4	6	17
OG0000422	4	6	5	2	17
OG0000423	4	13	0	0	17
OG0000424	1	2	2	12	17
OG0000425	3	2	12	0	17
OG0000426	1	13	3	0	17
OG0000427	0	16	0	1	17
OG0000428	0	16	0	1	17
OG0000429	0	1	16	0	17
OG0000430	0	0	17	0	17
OG0000431	0	0	17	0	17
OG0000432	0	0	1	16	17
OG0000433	0	0	0	17	17
OG0000434	0	0	0	17	17
OG0000435	0	0	0	17	17
OG0000436	0	0	0	17	17
OG0000437	0	0	0	17	17
OG0000438	0	0	0	17	17
OG0000439	0	0	0	17	17
OG0000440	0	0	0	17	17
OG0000441	0	0	0	17	17
OG0000442	0	0	0	17	17
OG0000443	16	0	0	0	16
OG0000444	16	0	0	0	16
OG0000445	11	0	1	4	16
OG0000446	5	5	6	0	16
OG0000447	5	1	5	5	16
OG0000448	11	2	2	1	16
OG0000449	3	1	8	4	16
OG0000450	6	4	6	0	16
OG0000451	9	5	2	0	16
OG0000452	5	5	4	2	16
OG0000453	3	8	5	0	16
OG0000454	5	4	6	1	16
OG0000455	1	1	14	0	16
OG0000456	4	0	12	0	16
OG0000457	3	6	6	1	16
OG0000458	11	4	0	1	16
OG0000459	16	0	0	0	16
OG0000460	3	1	5	7	16
OG0000461	6	1	6	3	16
OG0000462	4	5	2	5	16
OG0000463	6	2	5	3	16
OG0000464	2	6	3	5	16
OG0000465	6	1	9	0	16
OG0000466	1	0	0	15	16
OG0000467	8	5	3	0	16
OG0000468	2	1	1	12	16
OG0000469	3	12	1	0	16
OG0000470	3	2	10	1	16
OG0000471	1	6	9	0	16
OG0000472	2	3	7	4	16
OG0000473	3	9	3	1	16
OG0000474	3	4	6	3	16
OG0000475	4	8	4	0	16
OG0000476	10	2	4	0	16
OG0000477	1	0	15	0	16
OG0000478	1	3	12	0	16
OG0000479	4	5	4	3	16
OG0000480	3	1	1	11	16
OG0000481	3	4	6	3	16
OG0000482	1	0	0	15	16
OG0000483	1	13	1	1	16
OG0000484	0	2	14	0	16
OG0000485	0	1	14	1	16
OG0000486	0	0	16	0	16
OG0000487	0	0	16	0	16
OG0000488	0	0	1	15	16
OG0000489	0	0	16	0	16
OG0000490	0	0	3	13	16
OG0000491	0	0	0	16	16
OG0000492	0	0	0	16	16
OG0000493	0	0	0	16	16
OG0000494	0	0	0	16	16
OG0000495	0	0	0	16	16
OG0000496	0	0	0	16	16
OG0000497	0	0	0	16	16
OG0000498	0	0	0	16	16
OG0000499	0	0	0	16	16
OG0000500	7	7	1	0	15
OG0000501	12	2	0	1	15
OG0000502	3	11	1	0	15
OG0000503	7	4	3	1	15
OG0000504	13	2	0	0	15
OG0000505	5	5	3	2	15
OG0000506	15	0	0	0	15
OG0000507	7	4	2	2	15
OG0000508	1	1	1	12	15
OG0000509	15	0	0	0	15
OG0000510	7	3	2	3	15
OG0000511	2	0	3	10	15
OG0000512	11	4	0	0	15
OG0000513	13	0	2	0	15
OG0000514	6	1	6	2	15
OG0000515	4	10	1	0	15
OG0000516	9	2	4	0	15
OG0000517	3	3	3	6	15
OG0000518	3	3	2	7	15
OG0000519	1	2	1	11	15
OG0000520	4	4	5	2	15
OG0000521	1	1	1	12	15
OG0000522	4	6	5	0	15
OG0000523	1	1	2	11	15
OG0000524	1	14	0	0	15
OG0000525	2	1	10	2	15
OG0000526	3	7	4	1	15
OG0000527	1	1	13	0	15
OG0000528	3	4	2	6	15
OG0000529	6	2	4	3	15
OG0000530	1	0	14	0	15
OG0000531	1	0	0	14	15
OG0000532	0	5	9	1	15
OG0000533	0	1	14	0	15
OG0000534	0	1	0	14	15
OG0000535	0	0	14	1	15
OG0000536	0	0	15	0	15
OG0000537	0	0	1	14	15
OG0000538	0	0	0	15	15
OG0000539	0	0	0	15	15
OG0000540	0	0	0	15	15
OG0000541	0	0	0	15	15
OG0000542	0	0	0	15	15
OG0000543	0	0	0	15	15
OG0000544	0	0	0	15	15
OG0000545	0	0	0	15	15
OG0000546	0	0	0	15	15
OG0000547	0	0	0	15	15
OG0000548	0	0	0	15	15
OG0000549	0	0	0	15	15
OG0000550	0	0	0	15	15
OG0000551	0	0	0	15	15
OG0000552	0	0	0	15	15
OG0000553	0	0	0	15	15
OG0000554	0	0	0	15	15
OG0000555	0	0	0	15	15
OG0000556	0	0	0	15	15
OG0000557	5	5	4	0	14
OG0000558	5	4	5	0	14
OG0000559	1	6	5	2	14
OG0000560	2	10	1	1	14
OG0000561	3	3	2	6	14
OG0000562	3	5	6	0	14
OG0000563	4	6	3	1	14
OG0000564	8	5	1	0	14
OG0000565	5	7	2	0	14
OG0000566	3	2	2	7	14
OG0000567	8	0	1	5	14
OG0000568	1	5	8	0	14
OG0000569	4	2	5	3	14
OG0000570	2	2	2	8	14
OG0000571	1	1	1	11	14
OG0000572	3	1	1	9	14
OG0000573	2	3	1	8	14
OG0000574	5	9	0	0	14
OG0000575	7	5	1	1	14
OG0000576	10	1	1	2	14
OG0000577	3	3	7	1	14
OG0000578	2	4	5	3	14
OG0000579	5	0	9	0	14
OG0000580	2	1	6	5	14
OG0000581	3	4	3	4	14
OG0000582	5	3	6	0	14
OG0000583	4	3	4	3	14
OG0000584	9	2	3	0	14
OG0000585	1	1	1	11	14
OG0000586	3	5	5	1	14
OG0000587	6	2	4	2	14
OG0000588	4	6	4	0	14
OG0000589	3	4	7	0	14
OG0000590	2	6	5	1	14
OG0000591	6	3	4	1	14
OG0000592	1	0	13	0	14
OG0000593	1	1	1	11	14
OG0000594	2	5	6	1	14
OG0000595	4	4	5	1	14
OG0000596	1	2	6	5	14
OG0000597	2	5	7	0	14
OG0000598	1	0	13	0	14
OG0000599	1	0	2	11	14
OG0000600	1	1	1	11	14
OG0000601	1	2	11	0	14
OG0000602	0	14	0	0	14
OG0000603	0	2	11	1	14
OG0000604	0	2	12	0	14
OG0000605	0	14	0	0	14
OG0000606	0	14	0	0	14
OG0000607	0	3	11	0	14
OG0000608	0	14	0	0	14
OG0000609	0	0	14	0	14
OG0000610	0	0	14	0	14
OG0000611	0	0	14	0	14
OG0000612	0	0	14	0	14
OG0000613	0	0	14	0	14
OG0000614	0	0	14	0	14
OG0000615	0	0	5	9	14
OG0000616	0	0	1	13	14
OG0000617	0	0	14	0	14
OG0000618	0	0	1	13	14
OG0000619	0	0	1	13	14
OG0000620	0	0	1	13	14
OG0000621	0	0	0	14	14
OG0000622	0	0	0	14	14
OG0000623	0	0	0	14	14
OG0000624	0	0	0	14	14
OG0000625	0	0	0	14	14
OG0000626	0	0	0	14	14
OG0000627	0	0	0	14	14
OG0000628	0	0	0	14	14
OG0000629	0	0	0	14	14
OG0000630	0	0	0	14	14
OG0000631	0	0	0	14	14
OG0000632	0	0	0	14	14
OG0000633	0	0	0	14	14
OG0000634	0	0	0	14	14
OG0000635	0	0	0	14	14
OG0000636	12	1	0	0	13
OG0000637	13	0	0	0	13
OG0000638	11	0	2	0	13
OG0000639	5	2	6	0	13
OG0000640	1	1	11	0	13
OG0000641	2	0	9	2	13
OG0000642	5	3	3	2	13
OG0000643	2	2	5	4	13
OG0000644	4	4	4	1	13
OG0000645	3	3	7	0	13
OG0000646	4	2	6	1	13
OG0000647	1	2	9	1	13
OG0000648	6	3	4	0	13
OG0000649	5	4	4	0	13
OG0000650	9	2	2	0	13
OG0000651	3	4	6	0	13
OG0000652	3	2	6	2	13
OG0000653	6	4	2	1	13
OG0000654	13	0	0	0	13
OG0000655	6	4	3	0	13
OG0000656	1	0	12	0	13
OG0000657	12	0	1	0	13
OG0000658	11	2	0	0	13
OG0000659	3	1	1	8	13
OG0000660	10	1	2	0	13
OG0000661	5	2	5	1	13
OG0000662	1	0	12	0	13
OG0000663	3	3	6	1	13
OG0000664	13	0	0	0	13
OG0000665	1	6	6	0	13
OG0000666	2	1	2	8	13
OG0000667	1	12	0	0	13
OG0000668	3	2	5	3	13
OG0000669	1	0	12	0	13
OG0000670	2	3	6	2	13
OG0000671	2	2	3	6	13
OG0000672	4	3	3	3	13
OG0000673	3	7	3	0	13
OG0000674	2	6	5	0	13
OG0000675	6	1	6	0	13
OG0000676	2	2	2	7	13
OG0000677	4	3	4	2	13
OG0000678	3	2	7	1	13
OG0000679	1	0	0	12	13
OG0000680	1	1	7	4	13
OG0000681	13	0	0	0	13
OG0000682	1	1	0	11	13
OG0000683	4	0	9	0	13
OG0000684	4	4	4	1	13
OG0000685	3	4	4	2	13
OG0000686	4	4	5	0	13
OG0000687	1	0	0	12	13
OG0000688	2	2	1	8	13
OG0000689	4	9	0	0	13
OG0000690	2	4	7	0	13
OG0000691	1	10	2	0	13
OG0000692	3	1	2	7	13
OG0000693	1	0	0	12	13
OG0000694	1	0	12	0	13
OG0000695	1	5	1	6	13
OG0000696	0	12	1	0	13
OG0000697	0	13	0	0	13
OG0000698	0	3	6	4	13
OG0000699	0	13	0	0	13
OG0000700	0	12	1	0	13
OG0000701	0	1	1	11	13
OG0000702	0	2	1	10	13
OG0000703	0	13	0	0	13
OG0000704	0	1	11	1	13
OG0000705	0	1	11	1	13
OG0000706	0	0	13	0	13
OG0000707	0	0	13	0	13
OG0000708	0	0	3	10	13
OG0000709	0	0	1	12	13
OG0000710	0	0	13	0	13
OG0000711	0	0	1	12	13
OG0000712	0	0	1	12	13
OG0000713	0	0	0	13	13
OG0000714	0	0	0	13	13
OG0000715	0	0	0	13	13
OG0000716	0	0	0	13	13
OG0000717	0	0	0	13	13
OG0000718	0	0	0	13	13
OG0000719	0	0	0	13	13
OG0000720	0	0	0	13	13
OG0000721	0	0	0	13	13
OG0000722	0	0	0	13	13
OG0000723	0	0	0	13	13
OG0000724	3	4	4	1	12
OG0000725	9	1	1	1	12
OG0000726	12	0	0	0	12
OG0000727	2	6	2	2	12
OG0000728	8	2	1	1	12
OG0000729	9	2	1	0	12
OG0000730	1	1	1	9	12
OG0000731	3	2	3	4	12
OG0000732	1	1	1	9	12
OG0000733	8	1	3	0	12
OG0000734	4	4	3	1	12
OG0000735	7	0	5	0	12
OG0000736	2	4	6	0	12
OG0000737	3	4	5	0	12
OG0000738	4	6	1	1	12
OG0000739	1	1	10	0	12
OG0000740	2	10	0	0	12
OG0000741	1	2	7	2	12
OG0000742	2	0	0	10	12
OG0000743	3	2	6	1	12
OG0000744	2	2	3	5	12
OG0000745	5	3	3	1	12
OG0000746	7	1	3	1	12
OG0000747	3	0	4	5	12
OG0000748	2	5	4	1	12
OG0000749	3	2	6	1	12
OG0000750	1	0	0	11	12
OG0000751	1	0	0	11	12
OG0000752	2	5	4	1	12
OG0000753	12	0	0	0	12
OG0000754	4	3	5	0	12
OG0000755	2	3	5	2	12
OG0000756	5	1	3	3	12
OG0000757	11	0	1	0	12
OG0000758	4	4	4	0	12
OG0000759	12	0	0	0	12
OG0000760	1	1	1	9	12
OG0000761	1	1	9	1	12
OG0000762	5	1	6	0	12
OG0000763	3	3	4	2	12
OG0000764	5	3	2	2	12
OG0000765	4	3	4	1	12
OG0000766	2	4	5	1	12
OG0000767	12	0	0	0	12
OG0000768	3	2	7	0	12
OG0000769	3	2	6	1	12
OG0000770	4	1	4	3	12
OG0000771	7	0	5	0	12
OG0000772	3	4	2	3	12
OG0000773	2	5	4	1	12
OG0000774	11	1	0	0	12
OG0000775	1	3	0	8	12
OG0000776	1	1	1	9	12
OG0000777	2	1	4	5	12
OG0000778	1	3	7	1	12
OG0000779	3	3	4	2	12
OG0000780	1	1	2	8	12
OG0000781	2	10	0	0	12
OG0000782	1	1	1	9	12
OG0000783	2	10	0	0	12
OG0000784	1	1	5	5	12
OG0000785	2	9	1	0	12
OG0000786	1	10	1	0	12
OG0000787	3	1	6	2	12
OG0000788	1	11	0	0	12
OG0000789	1	1	3	7	12
OG0000790	1	0	11	0	12
OG0000791	1	0	0	11	12
OG0000792	0	1	1	10	12
OG0000793	0	10	2	0	12
OG0000794	0	7	5	0	12
OG0000795	0	11	1	0	12
OG0000796	0	12	0	0	12
OG0000797	0	11	1	0	12
OG0000798	0	0	12	0	12
OG0000799	0	0	12	0	12
OG0000800	0	0	12	0	12
OG0000801	0	0	12	0	12
OG0000802	0	0	12	0	12
OG0000803	0	0	1	11	12
OG0000804	0	0	12	0	12
OG0000805	0	0	12	0	12
OG0000806	0	0	12	0	12
OG0000807	0	0	11	1	12
OG0000808	0	0	12	0	12
OG0000809	0	0	0	12	12
OG0000810	0	0	0	12	12
OG0000811	0	0	0	12	12
OG0000812	0	0	0	12	12
OG0000813	0	0	0	12	12
OG0000814	0	0	0	12	12
OG0000815	0	0	0	12	12
OG0000816	0	0	0	12	12
OG0000817	0	0	0	12	12
OG0000818	0	0	0	12	12
OG0000819	0	0	0	12	12
OG0000820	0	0	0	12	12
OG0000821	0	0	0	12	12
OG0000822	0	0	0	12	12
OG0000823	0	0	0	12	12
OG0000824	0	0	0	12	12
OG0000825	0	0	0	12	12
OG0000826	0	0	0	12	12
OG0000827	0	0	0	12	12
OG0000828	0	0	0	12	12
OG0000829	0	0	0	12	12
OG0000830	0	0	0	12	12
OG0000831	0	0	0	12	12
OG0000832	0	0	0	12	12
OG0000833	0	0	0	12	12
OG0000834	2	0	9	0	11
OG0000835	5	3	3	0	11
OG0000836	1	6	4	0	11
OG0000837	11	0	0	0	11
OG0000838	1	1	1	8	11
OG0000839	4	3	3	1	11
OG0000840	5	3	2	1	11
OG0000841	2	1	4	4	11
OG0000842	5	0	5	1	11
OG0000843	1	1	2	7	11
OG0000844	1	0	10	0	11
OG0000845	1	4	0	6	11
OG0000846	8	3	0	0	11
OG0000847	1	1	3	6	11
OG0000848	2	2	4	3	11
OG0000849	3	3	3	2	11
OG0000850	3	2	6	0	11
OG0000851	11	0	0	0	11
OG0000852	3	0	2	6	11
OG0000853	9	2	0	0	11
OG0000854	2	3	5	1	11
OG0000855	11	0	0	0	11
OG0000856	3	3	4	1	11
OG0000857	3	6	2	0	11
OG0000858	3	1	1	6	11
OG0000859	3	4	2	2	11
OG0000860	6	5	0	0	11
OG0000861	2	7	1	1	11
OG0000862	8	0	0	3	11
OG0000863	1	9	1	0	11
OG0000864	5	2	4	0	11
OG0000865	7	1	3	0	11
OG0000866	1	8	2	0	11
OG0000867	4	0	1	6	11
OG0000868	2	0	9	0	11
OG0000869	10	1	0	0	11
OG0000870	3	1	7	0	11
OG0000871	6	1	4	0	11
OG0000872	3	3	3	2	11
OG0000873	2	3	2	4	11
OG0000874	7	4	0	0	11
OG0000875	3	3	2	3	11
OG0000876	1	1	1	8	11
OG0000877	2	2	4	3	11
OG0000878	1	0	10	0	11
OG0000879	3	4	2	2	11
OG0000880	2	2	3	4	11
OG0000881	1	4	5	1	11
OG0000882	2	2	3	4	11
OG0000883	2	4	3	2	11
OG0000884	3	3	3	2	11
OG0000885	1	1	3	6	11
OG0000886	1	1	1	8	11
OG0000887	6	1	4	0	11
OG0000888	2	4	5	0	11
OG0000889	4	2	4	1	11
OG0000890	4	2	2	3	11
OG0000891	1	8	2	0	11
OG0000892	1	0	9	1	11
OG0000893	3	2	2	4	11
OG0000894	3	2	6	0	11
OG0000895	1	1	1	8	11
OG0000896	2	2	2	5	11
OG0000897	1	10	0	0	11
OG0000898	11	0	0	0	11
OG0000899	2	2	3	4	11
OG0000900	2	1	3	5	11
OG0000901	3	5	2	1	11
OG0000902	2	3	3	3	11
OG0000903	1	6	4	0	11
OG0000904	1	2	2	6	11
OG0000905	1	1	5	4	11
OG0000906	1	10	0	0	11
OG0000907	2	0	0	9	11
OG0000908	3	1	4	3	11
OG0000909	6	2	3	0	11
OG0000910	1	1	1	8	11
OG0000911	1	4	6	0	11
OG0000912	1	0	10	0	11
OG0000913	0	11	0	0	11
OG0000914	0	11	0	0	11
OG0000915	0	9	0	2	11
OG0000916	0	3	6	2	11
OG0000917	0	11	0	0	11
OG0000918	0	2	9	0	11
OG0000919	0	11	0	0	11
OG0000920	0	11	0	0	11
OG0000921	0	1	9	1	11
OG0000922	0	0	11	0	11
OG0000923	0	0	11	0	11
OG0000924	0	0	11	0	11
OG0000925	0	0	11	0	11
OG0000926	0	0	2	9	11
OG0000927	0	0	11	0	11
OG0000928	0	0	11	0	11
OG0000929	0	0	11	0	11
OG0000930	0	0	8	3	11
OG0000931	0	0	11	0	11
OG0000932	0	0	11	0	11
OG0000933	0	0	11	0	11
OG0000934	0	0	11	0	11
OG0000935	0	0	2	9	11
OG0000936	0	0	0	11	11
OG0000937	0	0	0	11	11
OG0000938	0	0	0	11	11
OG0000939	0	0	0	11	11
OG0000940	0	0	0	11	11
OG0000941	0	0	0	11	11
OG0000942	0	0	0	11	11
OG0000943	0	0	0	11	11
OG0000944	0	0	0	11	11
OG0000945	0	0	0	11	11
OG0000946	0	0	0	11	11
OG0000947	0	0	0	11	11
OG0000948	0	0	0	11	11
OG0000949	0	0	0	11	11
OG0000950	0	0	0	11	11
OG0000951	0	0	0	11	11
OG0000952	0	0	0	11	11
OG0000953	0	0	0	11	11
OG0000954	0	0	0	11	11
OG0000955	0	0	0	11	11
OG0000956	0	0	0	11	11
OG0000957	0	0	0	11	11
OG0000958	0	0	0	11	11
OG0000959	0	0	0	11	11
OG0000960	0	0	0	11	11
OG0000961	0	0	0	11	11
OG0000962	6	1	3	0	10
OG0000963	4	3	2	1	10
OG0000964	2	3	4	1	10
OG0000965	6	4	0	0	10
OG0000966	2	2	6	0	10
OG0000967	2	1	4	3	10
OG0000968	7	1	2	0	10
OG0000969	1	1	1	7	10
OG0000970	3	4	1	2	10
OG0000971	1	1	2	6	10
OG0000972	3	3	4	0	10
OG0000973	9	1	0	0	10
OG0000974	1	2	5	2	10
OG0000975	9	0	0	1	10
OG0000976	5	2	3	0	10
OG0000977	2	1	2	5	10
OG0000978	4	3	2	1	10
OG0000979	7	2	1	0	10
OG0000980	3	2	3	2	10
OG0000981	1	1	2	6	10
OG0000982	4	3	3	0	10
OG0000983	8	1	1	0	10
OG0000984	9	0	0	1	10
OG0000985	2	1	5	2	10
OG0000986	8	2	0	0	10
OG0000987	10	0	0	0	10
OG0000988	2	4	4	0	10
OG0000989	2	6	0	2	10
OG0000990	2	2	2	4	10
OG0000991	5	3	1	1	10
OG0000992	9	1	0	0	10
OG0000993	3	2	5	0	10
OG0000994	3	2	4	1	10
OG0000995	10	0	0	0	10
OG0000996	6	2	1	1	10
OG0000997	4	3	2	1	10
OG0000998	10	0	0	0	10
OG0000999	1	0	9	0	10
OG0001000	4	5	1	0	10
OG0001001	6	1	3	0	10
OG0001002	2	3	3	2	10
OG0001003	4	2	1	3	10
OG0001004	4	1	4	1	10
OG0001005	3	4	2	1	10
OG0001006	2	1	7	0	10
OG0001007	4	0	4	2	10
OG0001008	1	1	5	3	10
OG0001009	4	1	5	0	10
OG0001010	3	2	2	3	10
OG0001011	5	1	4	0	10
OG0001012	10	0	0	0	10
OG0001013	3	0	7	0	10
OG0001014	3	2	5	0	10
OG0001015	3	1	4	2	10
OG0001016	1	1	1	7	10
OG0001017	1	1	1	7	10
OG0001018	3	3	3	1	10
OG0001019	5	3	0	2	10
OG0001020	3	2	5	0	10
OG0001021	1	0	9	0	10
OG0001022	1	1	1	7	10
OG0001023	5	1	4	0	10
OG0001024	1	0	9	0	10
OG0001025	3	2	5	0	10
OG0001026	1	1	3	5	10
OG0001027	1	1	8	0	10
OG0001028	3	1	3	3	10
OG0001029	3	2	5	0	10
OG0001030	4	0	6	0	10
OG0001031	7	0	3	0	10
OG0001032	2	4	1	3	10
OG0001033	3	2	3	2	10
OG0001034	4	3	3	0	10
OG0001035	4	2	4	0	10
OG0001036	3	6	1	0	10
OG0001037	8	1	1	0	10
OG0001038	1	1	0	8	10
OG0001039	3	1	6	0	10
OG0001040	2	4	4	0	10
OG0001041	3	2	5	0	10
OG0001042	8	1	1	0	10
OG0001043	2	4	2	2	10
OG0001044	2	4	2	2	10
OG0001045	1	4	5	0	10
OG0001046	2	0	0	8	10
OG0001047	1	1	7	1	10
OG0001048	1	0	9	0	10
OG0001049	3	3	3	1	10
OG0001050	2	2	1	5	10
OG0001051	2	3	5	0	10
OG0001052	1	2	6	1	10
OG0001053	2	0	8	0	10
OG0001054	1	8	1	0	10
OG0001055	2	3	3	2	10
OG0001056	1	0	1	8	10
OG0001057	1	2	7	0	10
OG0001058	1	1	8	0	10
OG0001059	1	1	8	0	10
OG0001060	1	8	1	0	10
OG0001061	3	2	5	0	10
OG0001062	1	0	9	0	10
OG0001063	0	7	2	1	10
OG0001064	0	1	0	9	10
OG0001065	0	1	6	3	10
OG0001066	0	10	0	0	10
OG0001067	0	1	1	8	10
OG0001068	0	2	8	0	10
OG0001069	0	10	0	0	10
OG0001070	0	10	0	0	10
OG0001071	0	10	0	0	10
OG0001072	0	1	0	9	10
OG0001073	0	10	0	0	10
OG0001074	0	1	9	0	10
OG0001075	0	8	2	0	10
OG0001076	0	1	0	9	10
OG0001077	0	1	0	9	10
OG0001078	0	0	10	0	10
OG0001079	0	0	10	0	10
OG0001080	0	0	10	0	10
OG0001081	0	0	10	0	10
OG0001082	0	0	3	7	10
OG0001083	0	0	10	0	10
OG0001084	0	0	10	0	10
OG0001085	0	0	10	0	10
OG0001086	0	0	10	0	10
OG0001087	0	0	10	0	10
OG0001088	0	0	4	6	10
OG0001089	0	0	10	0	10
OG0001090	0	0	9	1	10
OG0001091	0	0	1	9	10
OG0001092	0	0	1	9	10
OG0001093	0	0	0	10	10
OG0001094	0	0	0	10	10
OG0001095	0	0	0	10	10
OG0001096	0	0	0	10	10
OG0001097	0	0	0	10	10
OG0001098	0	0	0	10	10
OG0001099	0	0	0	10	10
OG0001100	0	0	0	10	10
OG0001101	0	0	0	10	10
OG0001102	0	0	0	10	10
OG0001103	0	0	0	10	10
OG0001104	0	0	0	10	10
OG0001105	0	0	0	10	10
OG0001106	0	0	0	10	10
OG0001107	0	0	0	10	10
OG0001108	0	0	0	10	10
OG0001109	0	0	0	10	10
OG0001110	0	0	0	10	10
OG0001111	0	0	0	10	10
OG0001112	0	0	0	10	10
OG0001113	0	0	0	10	10
OG0001114	0	0	0	10	10
OG0001115	0	0	0	10	10
OG0001116	0	0	0	10	10
OG0001117	0	0	0	10	10
OG0001118	0	0	0	10	10
OG0001119	0	0	0	10	10
OG0001120	0	0	0	10	10
OG0001121	0	0	0	10	10
OG0001122	0	0	0	10	10
OG0001123	0	0	0	10	10
OG0001124	0	0	0	10	10
OG0001125	0	0	0	10	10
OG0001126	0	0	0	10	10
OG0001127	0	0	0	10	10
OG0001128	0	0	0	10	10
OG0001129	0	0	0	10	10
OG0001130	5	2	1	1	9
OG0001131	7	1	1	0	9
OG0001132	1	1	1	6	9
OG0001133	2	1	4	2	9
OG0001134	9	0	0	0	9
OG0001135	1	1	1	6	9
OG0001136	9	0	0	0	9
OG0001137	3	2	2	2	9
OG0001138	2	1	1	5	9
OG0001139	2	2	4	1	9
OG0001140	6	1	2	0	9
OG0001141	2	2	2	3	9
OG0001142	9	0	0	0	9
OG0001143	7	1	1	0	9
OG0001144	5	0	4	0	9
OG0001145	5	0	2	2	9
OG0001146	7	1	1	0	9
OG0001147	7	2	0	0	9
OG0001148	2	1	1	5	9
OG0001149	3	3	2	1	9
OG0001150	1	1	1	6	9
OG0001151	5	2	2	0	9
OG0001152	2	1	6	0	9
OG0001153	4	0	4	1	9
OG0001154	1	1	1	6	9
OG0001155	8	1	0	0	9
OG0001156	1	3	4	1	9
OG0001157	9	0	0	0	9
OG0001158	5	2	2	0	9
OG0001159	8	0	1	0	9
OG0001160	2	6	1	0	9
OG0001161	5	1	2	1	9
OG0001162	5	0	3	1	9
OG0001163	2	2	3	2	9
OG0001164	9	0	0	0	9
OG0001165	4	2	2	1	9
OG0001166	1	1	6	1	9
OG0001167	9	0	0	0	9
OG0001168	2	7	0	0	9
OG0001169	5	2	2	0	9
OG0001170	2	6	1	0	9
OG0001171	5	2	1	1	9
OG0001172	3	3	2	1	9
OG0001173	1	5	2	1	9
OG0001174	7	0	2	0	9
OG0001175	9	0	0	0	9
OG0001176	9	0	0	0	9
OG0001177	6	2	1	0	9
OG0001178	6	1	2	0	9
OG0001179	1	1	1	6	9
OG0001180	2	3	2	2	9
OG0001181	3	3	2	1	9
OG0001182	6	2	1	0	9
OG0001183	1	3	1	4	9
OG0001184	2	5	2	0	9
OG0001185	3	0	5	1	9
OG0001186	1	1	1	6	9
OG0001187	2	2	4	1	9
OG0001188	3	2	3	1	9
OG0001189	8	1	0	0	9
OG0001190	2	4	3	0	9
OG0001191	9	0	0	0	9
OG0001192	9	0	0	0	9
OG0001193	6	1	2	0	9
OG0001194	4	2	3	0	9
OG0001195	2	0	7	0	9
OG0001196	3	2	4	0	9
OG0001197	9	0	0	0	9
OG0001198	3	3	2	1	9
OG0001199	3	2	2	2	9
OG0001200	4	2	2	1	9
OG0001201	1	1	1	6	9
OG0001202	1	2	5	1	9
OG0001203	1	0	8	0	9
OG0001204	1	1	1	6	9
OG0001205	9	0	0	0	9
OG0001206	2	0	0	7	9
OG0001207	9	0	0	0	9
OG0001208	2	2	3	2	9
OG0001209	9	0	0	0	9
OG0001210	4	1	2	2	9
OG0001211	5	3	1	0	9
OG0001212	2	2	2	3	9
OG0001213	2	2	2	3	9
OG0001214	3	4	1	1	9
OG0001215	9	0	0	0	9
OG0001216	3	2	4	0	9
OG0001217	2	1	1	5	9
OG0001218	3	2	1	3	9
OG0001219	3	3	3	0	9
OG0001220	2	0	7	0	9
OG0001221	1	0	6	2	9
OG0001222	1	1	1	6	9
OG0001223	3	2	2	2	9
OG0001224	4	3	1	1	9
OG0001225	2	2	4	1	9
OG0001226	3	0	6	0	9
OG0001227	3	2	3	1	9
OG0001228	1	8	0	0	9
OG0001229	9	0	0	0	9
OG0001230	2	1	2	4	9
OG0001231	4	2	2	1	9
OG0001232	4	3	2	0	9
OG0001233	4	0	4	1	9
OG0001234	3	2	3	1	9
OG0001235	3	3	3	0	9
OG0001236	2	1	3	3	9
OG0001237	2	3	2	2	9
OG0001238	2	2	4	1	9
OG0001239	1	6	2	0	9
OG0001240	3	4	2	0	9
OG0001241	1	1	1	6	9
OG0001242	3	2	3	1	9
OG0001243	2	4	1	2	9
OG0001244	2	1	6	0	9
OG0001245	2	0	0	7	9
OG0001246	1	3	2	3	9
OG0001247	1	0	7	1	9
OG0001248	3	2	2	2	9
OG0001249	2	1	2	4	9
OG0001250	2	2	3	2	9
OG0001251	2	4	3	0	9
OG0001252	1	0	7	1	9
OG0001253	3	2	1	3	9
OG0001254	9	0	0	0	9
OG0001255	5	2	2	0	9
OG0001256	3	1	5	0	9
OG0001257	2	5	1	1	9
OG0001258	5	1	3	0	9
OG0001259	3	2	2	2	9
OG0001260	2	2	5	0	9
OG0001261	2	0	0	7	9
OG0001262	1	1	6	1	9
OG0001263	4	1	1	3	9
OG0001264	5	2	2	0	9
OG0001265	2	1	1	5	9
OG0001266	3	2	2	2	9
OG0001267	2	4	2	1	9
OG0001268	2	1	1	5	9
OG0001269	1	8	0	0	9
OG0001270	3	4	1	1	9
OG0001271	1	1	6	1	9
OG0001272	1	7	1	0	9
OG0001273	1	2	6	0	9
OG0001274	1	3	5	0	9
OG0001275	1	1	1	6	9
OG0001276	1	0	1	7	9
OG0001277	1	1	1	6	9
OG0001278	2	6	1	0	9
OG0001279	1	2	1	5	9
OG0001280	1	1	1	6	9
OG0001281	1	0	6	2	9
OG0001282	1	0	1	7	9
OG0001283	1	0	0	8	9
OG0001284	0	9	0	0	9
OG0001285	0	9	0	0	9
OG0001286	0	2	7	0	9
OG0001287	0	2	3	4	9
OG0001288	0	9	0	0	9
OG0001289	0	6	3	0	9
OG0001290	0	9	0	0	9
OG0001291	0	9	0	0	9
OG0001292	0	2	6	1	9
OG0001293	0	8	1	0	9
OG0001294	0	9	0	0	9
OG0001295	0	1	8	0	9
OG0001296	0	1	0	8	9
OG0001297	0	9	0	0	9
OG0001298	0	9	0	0	9
OG0001299	0	1	8	0	9
OG0001300	0	0	9	0	9
OG0001301	0	0	9	0	9
OG0001302	0	0	9	0	9
OG0001303	0	0	9	0	9
OG0001304	0	0	9	0	9
OG0001305	0	0	9	0	9
OG0001306	0	0	9	0	9
OG0001307	0	0	8	1	9
OG0001308	0	0	9	0	9
OG0001309	0	0	9	0	9
OG0001310	0	0	9	0	9
OG0001311	0	0	9	0	9
OG0001312	0	0	9	0	9
OG0001313	0	0	3	6	9
OG0001314	0	0	1	8	9
OG0001315	0	0	9	0	9
OG0001316	0	0	9	0	9
OG0001317	0	0	9	0	9
OG0001318	0	0	9	0	9
OG0001319	0	0	1	8	9
OG0001320	0	0	9	0	9
OG0001321	0	0	9	0	9
OG0001322	0	0	9	0	9
OG0001323	0	0	9	0	9
OG0001324	0	0	1	8	9
OG0001325	0	0	1	8	9
OG0001326	0	0	1	8	9
OG0001327	0	0	1	8	9
OG0001328	0	0	0	9	9
OG0001329	0	0	0	9	9
OG0001330	0	0	0	9	9
OG0001331	0	0	0	9	9
OG0001332	0	0	0	9	9
OG0001333	0	0	0	9	9
OG0001334	0	0	0	9	9
OG0001335	0	0	0	9	9
OG0001336	0	0	0	9	9
OG0001337	0	0	0	9	9
OG0001338	0	0	0	9	9
OG0001339	0	0	0	9	9
OG0001340	0	0	0	9	9
OG0001341	0	0	0	9	9
OG0001342	0	0	0	9	9
OG0001343	0	0	0	9	9
OG0001344	0	0	0	9	9
OG0001345	0	0	0	9	9
OG0001346	0	0	0	9	9
OG0001347	0	0	0	9	9
OG0001348	0	0	0	9	9
OG0001349	2	2	1	3	8
OG0001350	2	1	4	1	8
OG0001351	6	1	1	0	8
OG0001352	3	2	3	0	8
OG0001353	8	0	0	0	8
OG0001354	2	2	3	1	8
OG0001355	1	1	5	1	8
OG0001356	5	1	1	1	8
OG0001357	1	1	1	5	8
OG0001358	3	3	1	1	8
OG0001359	5	0	3	0	8
OG0001360	4	1	2	1	8
OG0001361	2	3	1	2	8
OG0001362	8	0	0	0	8
OG0001363	3	2	2	1	8
OG0001364	1	1	1	5	8
OG0001365	3	2	3	0	8
OG0001366	5	0	2	1	8
OG0001367	1	1	1	5	8
OG0001368	2	4	1	1	8
OG0001369	2	1	4	1	8
OG0001370	8	0	0	0	8
OG0001371	2	2	4	0	8
OG0001372	3	2	2	1	8
OG0001373	2	0	2	4	8
OG0001374	3	1	3	1	8
OG0001375	3	4	1	0	8
OG0001376	3	2	2	1	8
OG0001377	4	2	2	0	8
OG0001378	1	1	1	5	8
OG0001379	5	1	2	0	8
OG0001380	2	2	3	1	8
OG0001381	7	1	0	0	8
OG0001382	3	1	2	2	8
OG0001383	4	2	0	2	8
OG0001384	2	1	3	2	8
OG0001385	2	3	3	0	8
OG0001386	2	1	4	1	8
OG0001387	7	0	1	0	8
OG0001388	1	1	6	0	8
OG0001389	8	0	0	0	8
OG0001390	1	1	1	5	8
OG0001391	3	2	1	2	8
OG0001392	3	2	3	0	8
OG0001393	2	2	1	3	8
OG0001394	2	2	2	2	8
OG0001395	2	1	3	2	8
OG0001396	3	4	1	0	8
OG0001397	1	0	0	7	8
OG0001398	4	2	1	1	8
OG0001399	5	0	3	0	8
OG0001400	1	1	1	5	8
OG0001401	1	2	4	1	8
OG0001402	2	2	2	2	8
OG0001403	2	2	4	0	8
OG0001404	6	1	0	1	8
OG0001405	2	1	2	3	8
OG0001406	4	1	3	0	8
OG0001407	1	0	7	0	8
OG0001408	2	0	5	1	8
OG0001409	7	0	1	0	8
OG0001410	3	2	1	2	8
OG0001411	2	2	2	2	8
OG0001412	2	5	1	0	8
OG0001413	4	0	3	1	8
OG0001414	1	1	1	5	8
OG0001415	8	0	0	0	8
OG0001416	2	2	2	2	8
OG0001417	2	2	3	1	8
OG0001418	1	3	4	0	8
OG0001419	1	1	6	0	8
OG0001420	2	2	1	3	8
OG0001421	3	3	2	0	8
OG0001422	3	2	1	2	8
OG0001423	5	1	2	0	8
OG0001424	1	0	7	0	8
OG0001425	4	0	2	2	8
OG0001426	2	1	1	4	8
OG0001427	3	4	0	1	8
OG0001428	3	2	2	1	8
OG0001429	6	1	1	0	8
OG0001430	1	1	1	5	8
OG0001431	2	2	4	0	8
OG0001432	2	2	2	2	8
OG0001433	4	1	2	1	8
OG0001434	2	2	3	1	8
OG0001435	1	1	1	5	8
OG0001436	2	2	2	2	8
OG0001437	3	4	1	0	8
OG0001438	7	0	1	0	8
OG0001439	1	2	2	3	8
OG0001440	5	1	1	1	8
OG0001441	1	1	1	5	8
OG0001442	2	2	2	2	8
OG0001443	7	0	1	0	8
OG0001444	3	1	1	3	8
OG0001445	3	1	2	2	8
OG0001446	2	2	2	2	8
OG0001447	2	2	2	2	8
OG0001448	3	3	1	1	8
OG0001449	2	2	3	1	8
OG0001450	3	2	2	1	8
OG0001451	4	1	3	0	8
OG0001452	1	1	1	5	8
OG0001453	8	0	0	0	8
OG0001454	1	0	2	5	8
OG0001455	1	6	1	0	8
OG0001456	1	1	1	5	8
OG0001457	1	1	1	5	8
OG0001458	1	1	4	2	8
OG0001459	5	0	1	2	8
OG0001460	1	1	2	4	8
OG0001461	2	2	1	3	8
OG0001462	1	1	6	0	8
OG0001463	3	2	2	1	8
OG0001464	4	1	2	1	8
OG0001465	2	2	2	2	8
OG0001466	1	1	3	3	8
OG0001467	2	2	2	2	8
OG0001468	2	1	4	1	8
OG0001469	2	2	2	2	8
OG0001470	5	0	3	0	8
OG0001471	5	1	1	1	8
OG0001472	3	3	2	0	8
OG0001473	3	2	2	1	8
OG0001474	8	0	0	0	8
OG0001475	2	4	1	1	8
OG0001476	5	3	0	0	8
OG0001477	4	1	3	0	8
OG0001478	1	3	3	1	8
OG0001479	2	2	2	2	8
OG0001480	1	3	1	3	8
OG0001481	4	1	1	2	8
OG0001482	2	0	6	0	8
OG0001483	3	4	0	1	8
OG0001484	3	2	2	1	8
OG0001485	1	0	1	6	8
OG0001486	2	2	2	2	8
OG0001487	3	2	2	1	8
OG0001488	2	1	2	3	8
OG0001489	2	3	1	2	8
OG0001490	7	1	0	0	8
OG0001491	4	0	4	0	8
OG0001492	5	2	1	0	8
OG0001493	3	3	1	1	8
OG0001494	4	2	2	0	8
OG0001495	1	0	7	0	8
OG0001496	2	4	1	1	8
OG0001497	3	1	2	2	8
OG0001498	2	2	1	3	8
OG0001499	2	1	5	0	8
OG0001500	1	1	1	5	8
OG0001501	2	4	2	0	8
OG0001502	1	4	3	0	8
OG0001503	1	1	5	1	8
OG0001504	2	2	2	2	8
OG0001505	3	1	4	0	8
OG0001506	8	0	0	0	8
OG0001507	3	2	2	1	8
OG0001508	2	0	6	0	8
OG0001509	1	1	5	1	8
OG0001510	3	2	2	1	8
OG0001511	1	7	0	0	8
OG0001512	3	2	2	1	8
OG0001513	2	2	2	2	8
OG0001514	3	1	3	1	8
OG0001515	1	1	2	4	8
OG0001516	1	1	2	4	8
OG0001517	2	6	0	0	8
OG0001518	2	3	3	0	8
OG0001519	1	1	1	5	8
OG0001520	2	3	3	0	8
OG0001521	3	2	2	1	8
OG0001522	2	1	4	1	8
OG0001523	2	2	3	1	8
OG0001524	2	2	3	1	8
OG0001525	1	6	0	1	8
OG0001526	2	2	2	2	8
OG0001527	3	2	1	2	8
OG0001528	2	3	2	1	8
OG0001529	6	1	1	0	8
OG0001530	8	0	0	0	8
OG0001531	1	2	1	4	8
OG0001532	7	0	1	0	8
OG0001533	1	1	6	0	8
OG0001534	6	1	1	0	8
OG0001535	1	6	1	0	8
OG0001536	4	4	0	0	8
OG0001537	3	2	1	2	8
OG0001538	2	2	2	2	8
OG0001539	3	3	1	1	8
OG0001540	4	1	2	1	8
OG0001541	2	2	1	3	8
OG0001542	2	1	4	1	8
OG0001543	2	2	1	3	8
OG0001544	1	1	5	1	8
OG0001545	1	1	4	2	8
OG0001546	1	1	1	5	8
OG0001547	1	1	0	6	8
OG0001548	3	1	4	0	8
OG0001549	3	2	2	1	8
OG0001550	1	1	1	5	8
OG0001551	1	4	1	2	8
OG0001552	2	4	1	1	8
OG0001553	2	1	4	1	8
OG0001554	1	1	4	2	8
OG0001555	2	3	2	1	8
OG0001556	3	1	2	2	8
OG0001557	1	1	6	0	8
OG0001558	1	3	3	1	8
OG0001559	1	1	2	4	8
OG0001560	2	2	2	2	8
OG0001561	2	2	4	0	8
OG0001562	2	3	3	0	8
OG0001563	1	0	7	0	8
OG0001564	1	1	1	5	8
OG0001565	3	2	3	0	8
OG0001566	1	1	1	5	8
OG0001567	1	7	0	0	8
OG0001568	1	0	7	0	8
OG0001569	1	3	4	0	8
OG0001570	6	1	0	1	8
OG0001571	1	1	1	5	8
OG0001572	1	3	2	2	8
OG0001573	1	0	0	7	8
OG0001574	2	2	2	2	8
OG0001575	2	0	6	0	8
OG0001576	1	4	3	0	8
OG0001577	1	3	4	0	8
OG0001578	1	0	7	0	8
OG0001579	2	3	3	0	8
OG0001580	1	1	4	2	8
OG0001581	1	1	3	3	8
OG0001582	1	1	6	0	8
OG0001583	1	0	0	7	8
OG0001584	1	1	5	1	8
OG0001585	0	8	0	0	8
OG0001586	0	8	0	0	8
OG0001587	0	7	1	0	8
OG0001588	0	1	1	6	8
OG0001589	0	8	0	0	8
OG0001590	0	8	0	0	8
OG0001591	0	8	0	0	8
OG0001592	0	8	0	0	8
OG0001593	0	1	7	0	8
OG0001594	0	8	0	0	8
OG0001595	0	6	2	0	8
OG0001596	0	7	1	0	8
OG0001597	0	8	0	0	8
OG0001598	0	7	1	0	8
OG0001599	0	7	1	0	8
OG0001600	0	7	1	0	8
OG0001601	0	8	0	0	8
OG0001602	0	8	0	0	8
OG0001603	0	0	8	0	8
OG0001604	0	0	8	0	8
OG0001605	0	0	8	0	8
OG0001606	0	0	8	0	8
OG0001607	0	0	8	0	8
OG0001608	0	0	8	0	8
OG0001609	0	0	8	0	8
OG0001610	0	0	8	0	8
OG0001611	0	0	8	0	8
OG0001612	0	0	6	2	8
OG0001613	0	0	8	0	8
OG0001614	0	0	8	0	8
OG0001615	0	0	8	0	8
OG0001616	0	0	8	0	8
OG0001617	0	0	8	0	8
OG0001618	0	0	8	0	8
OG0001619	0	0	8	0	8
OG0001620	0	0	8	0	8
OG0001621	0	0	8	0	8
OG0001622	0	0	4	4	8
OG0001623	0	0	8	0	8
OG0001624	0	0	1	7	8
OG0001625	0	0	1	7	8
OG0001626	0	0	1	7	8
OG0001627	0	0	8	0	8
OG0001628	0	0	8	0	8
OG0001629	0	0	0	8	8
OG0001630	0	0	0	8	8
OG0001631	0	0	0	8	8
OG0001632	0	0	0	8	8
OG0001633	0	0	0	8	8
OG0001634	0	0	0	8	8
OG0001635	0	0	0	8	8
OG0001636	0	0	0	8	8
OG0001637	0	0	0	8	8
OG0001638	0	0	0	8	8
OG0001639	0	0	0	8	8
OG0001640	0	0	0	8	8
OG0001641	0	0	0	8	8
OG0001642	0	0	0	8	8
OG0001643	0	0	0	8	8
OG0001644	0	0	0	8	8
OG0001645	0	0	0	8	8
OG0001646	0	0	0	8	8
OG0001647	0	0	0	8	8
OG0001648	0	0	0	8	8
OG0001649	0	0	0	8	8
OG0001650	0	0	0	8	8
OG0001651	0	0	0	8	8
OG0001652	0	0	0	8	8
OG0001653	0	0	0	8	8
OG0001654	0	0	0	8	8
OG0001655	0	0	0	8	8
OG0001656	0	0	0	8	8
OG0001657	0	0	0	8	8
OG0001658	0	0	0	8	8
OG0001659	0	0	0	8	8
OG0001660	0	0	0	8	8
OG0001661	0	0	0	8	8
OG0001662	0	0	0	8	8
OG0001663	0	0	0	8	8
OG0001664	0	0	0	8	8
OG0001665	0	0	0	8	8
OG0001666	0	0	0	8	8
OG0001667	0	0	0	8	8
OG0001668	0	0	0	8	8
OG0001669	0	0	0	8	8
OG0001670	0	0	0	8	8
OG0001671	0	0	0	8	8
OG0001672	2	1	2	2	7
OG0001673	6	1	0	0	7
OG0001674	3	2	2	0	7
OG0001675	1	1	2	3	7
OG0001676	2	2	2	1	7
OG0001677	2	2	2	1	7
OG0001678	1	2	2	2	7
OG0001679	3	1	2	1	7
OG0001680	7	0	0	0	7
OG0001681	3	1	2	1	7
OG0001682	1	1	3	2	7
OG0001683	2	2	2	1	7
OG0001684	4	2	1	0	7
OG0001685	7	0	0	0	7
OG0001686	2	2	2	1	7
OG0001687	2	2	1	2	7
OG0001688	3	1	2	1	7
OG0001689	1	1	1	4	7
OG0001690	2	1	2	2	7
OG0001691	3	1	3	0	7
OG0001692	3	1	2	1	7
OG0001693	7	0	0	0	7
OG0001694	1	1	1	4	7
OG0001695	5	0	2	0	7
OG0001696	5	1	1	0	7
OG0001697	7	0	0	0	7
OG0001698	2	2	0	3	7
OG0001699	2	2	2	1	7
OG0001700	2	1	1	3	7
OG0001701	2	1	3	1	7
OG0001702	3	1	3	0	7
OG0001703	1	1	1	4	7
OG0001704	3	1	1	2	7
OG0001705	1	1	1	4	7
OG0001706	2	1	2	2	7
OG0001707	2	3	2	0	7
OG0001708	4	0	3	0	7
OG0001709	1	1	1	4	7
OG0001710	2	2	2	1	7
OG0001711	2	1	3	1	7
OG0001712	2	2	2	1	7
OG0001713	2	2	2	1	7
OG0001714	1	1	1	4	7
OG0001715	2	3	1	1	7
OG0001716	1	1	1	4	7
OG0001717	3	0	0	4	7
OG0001718	2	0	2	3	7
OG0001719	3	2	1	1	7
OG0001720	7	0	0	0	7
OG0001721	6	1	0	0	7
OG0001722	1	1	5	0	7
OG0001723	3	1	1	2	7
OG0001724	1	0	0	6	7
OG0001725	2	0	1	4	7
OG0001726	7	0	0	0	7
OG0001727	3	1	1	2	7
OG0001728	2	3	1	1	7
OG0001729	3	1	2	1	7
OG0001730	1	1	2	3	7
OG0001731	2	2	2	1	7
OG0001732	2	0	1	4	7
OG0001733	2	3	1	1	7
OG0001734	5	1	1	0	7
OG0001735	6	1	0	0	7
OG0001736	7	0	0	0	7
OG0001737	3	2	1	1	7
OG0001738	2	1	1	3	7
OG0001739	4	1	1	1	7
OG0001740	1	1	3	2	7
OG0001741	2	2	1	2	7
OG0001742	2	2	2	1	7
OG0001743	7	0	0	0	7
OG0001744	2	1	1	3	7
OG0001745	4	2	1	0	7
OG0001746	2	2	2	1	7
OG0001747	2	2	2	1	7
OG0001748	3	1	1	2	7
OG0001749	7	0	0	0	7
OG0001750	1	1	1	4	7
OG0001751	2	2	1	2	7
OG0001752	1	1	2	3	7
OG0001753	6	1	0	0	7
OG0001754	7	0	0	0	7
OG0001755	5	0	2	0	7
OG0001756	2	2	2	1	7
OG0001757	1	2	2	2	7
OG0001758	2	3	1	1	7
OG0001759	1	1	1	4	7
OG0001760	2	1	1	3	7
OG0001761	2	1	1	3	7
OG0001762	1	3	2	1	7
OG0001763	2	2	2	1	7
OG0001764	4	1	2	0	7
OG0001765	6	1	0	0	7
OG0001766	3	1	2	1	7
OG0001767	3	4	0	0	7
OG0001768	2	1	1	3	7
OG0001769	2	2	2	1	7
OG0001770	3	1	2	1	7
OG0001771	2	2	2	1	7
OG0001772	1	1	1	4	7
OG0001773	7	0	0	0	7
OG0001774	2	1	2	2	7
OG0001775	5	1	1	0	7
OG0001776	2	1	2	2	7
OG0001777	7	0	0	0	7
OG0001778	4	0	3	0	7
OG0001779	2	2	2	1	7
OG0001780	2	1	3	1	7
OG0001781	1	1	4	1	7
OG0001782	2	2	2	1	7
OG0001783	2	2	2	1	7
OG0001784	4	3	0	0	7
OG0001785	7	0	0	0	7
OG0001786	2	3	2	0	7
OG0001787	2	2	2	1	7
OG0001788	7	0	0	0	7
OG0001789	1	1	1	4	7
OG0001790	1	1	1	4	7
OG0001791	1	1	1	4	7
OG0001792	2	2	2	1	7
OG0001793	2	2	2	1	7
OG0001794	2	2	2	1	7
OG0001795	2	2	2	1	7
OG0001796	2	2	2	1	7
OG0001797	1	1	1	4	7
OG0001798	2	2	2	1	7
OG0001799	2	1	4	0	7
OG0001800	2	2	2	1	7
OG0001801	1	1	1	4	7
OG0001802	2	2	2	1	7
OG0001803	2	1	1	3	7
OG0001804	3	1	2	1	7
OG0001805	2	2	2	1	7
OG0001806	2	0	5	0	7
OG0001807	2	3	2	0	7
OG0001808	2	2	2	1	7
OG0001809	1	1	1	4	7
OG0001810	4	1	2	0	7
OG0001811	5	0	1	1	7
OG0001812	6	1	0	0	7
OG0001813	7	0	0	0	7
OG0001814	2	0	5	0	7
OG0001815	2	2	2	1	7
OG0001816	1	4	2	0	7
OG0001817	2	2	2	1	7
OG0001818	2	2	2	1	7
OG0001819	2	2	2	1	7
OG0001820	3	1	1	2	7
OG0001821	2	2	0	3	7
OG0001822	2	1	3	1	7
OG0001823	1	2	1	3	7
OG0001824	2	1	2	2	7
OG0001825	5	2	0	0	7
OG0001826	1	4	1	1	7
OG0001827	3	0	4	0	7
OG0001828	1	1	1	4	7
OG0001829	2	1	1	3	7
OG0001830	2	2	2	1	7
OG0001831	2	2	0	3	7
OG0001832	1	0	0	6	7
OG0001833	3	1	1	2	7
OG0001834	1	3	2	1	7
OG0001835	1	3	3	0	7
OG0001836	1	1	2	3	7
OG0001837	3	1	3	0	7
OG0001838	2	2	2	1	7
OG0001839	2	2	2	1	7
OG0001840	2	1	1	3	7
OG0001841	2	1	2	2	7
OG0001842	2	1	2	2	7
OG0001843	3	2	1	1	7
OG0001844	2	1	1	3	7
OG0001845	3	0	2	2	7
OG0001846	2	2	2	1	7
OG0001847	3	2	1	1	7
OG0001848	2	1	1	3	7
OG0001849	2	4	1	0	7
OG0001850	2	2	2	1	7
OG0001851	2	1	1	3	7
OG0001852	1	3	3	0	7
OG0001853	2	1	2	2	7
OG0001854	1	0	6	0	7
OG0001855	2	0	5	0	7
OG0001856	1	4	1	1	7
OG0001857	2	2	2	1	7
OG0001858	1	0	6	0	7
OG0001859	1	1	1	4	7
OG0001860	3	1	1	2	7
OG0001861	3	1	2	1	7
OG0001862	2	2	2	1	7
OG0001863	4	1	1	1	7
OG0001864	4	1	2	0	7
OG0001865	2	2	2	1	7
OG0001866	2	1	2	2	7
OG0001867	7	0	0	0	7
OG0001868	2	2	2	1	7
OG0001869	3	4	0	0	7
OG0001870	2	2	2	1	7
OG0001871	1	1	4	1	7
OG0001872	3	2	1	1	7
OG0001873	2	1	2	2	7
OG0001874	1	1	3	2	7
OG0001875	2	3	2	0	7
OG0001876	1	1	2	3	7
OG0001877	7	0	0	0	7
OG0001878	2	0	3	2	7
OG0001879	3	0	4	0	7
OG0001880	3	2	1	1	7
OG0001881	7	0	0	0	7
OG0001882	2	4	1	0	7
OG0001883	2	2	1	2	7
OG0001884	2	2	2	1	7
OG0001885	1	2	1	3	7
OG0001886	2	2	1	2	7
OG0001887	1	2	4	0	7
OG0001888	5	1	1	0	7
OG0001889	6	1	0	0	7
OG0001890	1	3	1	2	7
OG0001891	1	1	1	4	7
OG0001892	5	0	1	1	7
OG0001893	2	2	2	1	7
OG0001894	2	3	1	1	7
OG0001895	3	1	3	0	7
OG0001896	1	4	1	1	7
OG0001897	2	1	2	2	7
OG0001898	2	2	2	1	7
OG0001899	1	2	3	1	7
OG0001900	2	5	0	0	7
OG0001901	2	2	2	1	7
OG0001902	2	2	2	1	7
OG0001903	4	2	1	0	7
OG0001904	2	2	1	2	7
OG0001905	2	3	2	0	7
OG0001906	1	1	5	0	7
OG0001907	1	1	1	4	7
OG0001908	1	6	0	0	7
OG0001909	1	6	0	0	7
OG0001910	7	0	0	0	7
OG0001911	1	1	3	2	7
OG0001912	1	1	1	4	7
OG0001913	1	2	3	1	7
OG0001914	1	1	5	0	7
OG0001915	2	1	1	3	7
OG0001916	3	2	2	0	7
OG0001917	2	1	2	2	7
OG0001918	4	1	1	1	7
OG0001919	2	2	2	1	7
OG0001920	2	3	2	0	7
OG0001921	3	2	1	1	7
OG0001922	3	1	1	2	7
OG0001923	1	2	1	3	7
OG0001924	1	2	2	2	7
OG0001925	2	2	2	1	7
OG0001926	7	0	0	0	7
OG0001927	1	1	2	3	7
OG0001928	2	2	2	1	7
OG0001929	2	2	2	1	7
OG0001930	2	3	1	1	7
OG0001931	1	2	3	1	7
OG0001932	1	1	1	4	7
OG0001933	2	2	1	2	7
OG0001934	1	2	2	2	7
OG0001935	2	1	1	3	7
OG0001936	2	2	2	1	7
OG0001937	5	1	1	0	7
OG0001938	2	3	1	1	7
OG0001939	1	1	1	4	7
OG0001940	2	3	1	1	7
OG0001941	1	4	1	1	7
OG0001942	2	2	3	0	7
OG0001943	1	0	4	2	7
OG0001944	1	4	1	1	7
OG0001945	5	1	1	0	7
OG0001946	1	1	1	4	7
OG0001947	1	2	2	2	7
OG0001948	1	1	1	4	7
OG0001949	1	1	1	4	7
OG0001950	2	2	3	0	7
OG0001951	2	1	4	0	7
OG0001952	1	1	1	4	7
OG0001953	3	1	1	2	7
OG0001954	2	2	2	1	7
OG0001955	1	2	4	0	7
OG0001956	1	1	1	4	7
OG0001957	2	2	3	0	7
OG0001958	1	2	2	2	7
OG0001959	1	1	1	4	7
OG0001960	1	2	2	2	7
OG0001961	2	5	0	0	7
OG0001962	2	1	2	2	7
OG0001963	3	1	2	1	7
OG0001964	4	1	1	1	7
OG0001965	2	2	1	2	7
OG0001966	1	0	5	1	7
OG0001967	1	1	4	1	7
OG0001968	4	2	1	0	7
OG0001969	1	1	5	0	7
OG0001970	1	2	2	2	7
OG0001971	1	1	4	1	7
OG0001972	1	1	1	4	7
OG0001973	3	2	2	0	7
OG0001974	2	2	2	1	7
OG0001975	2	1	4	0	7
OG0001976	2	0	0	5	7
OG0001977	1	0	0	6	7
OG0001978	1	1	3	2	7
OG0001979	1	1	3	2	7
OG0001980	1	1	1	4	7
OG0001981	2	2	2	1	7
OG0001982	1	6	0	0	7
OG0001983	2	1	1	3	7
OG0001984	2	2	2	1	7
OG0001985	2	1	4	0	7
OG0001986	1	2	3	1	7
OG0001987	1	1	1	4	7
OG0001988	2	1	1	3	7
OG0001989	1	0	2	4	7
OG0001990	1	2	4	0	7
OG0001991	2	2	2	1	7
OG0001992	1	1	1	4	7
OG0001993	2	0	5	0	7
OG0001994	2	3	2	0	7
OG0001995	1	1	2	3	7
OG0001996	0	2	5	0	7
OG0001997	0	1	1	5	7
OG0001998	0	7	0	0	7
OG0001999	0	7	0	0	7
OG0002000	0	7	0	0	7
OG0002001	0	2	5	0	7
OG0002002	0	7	0	0	7
OG0002003	0	1	6	0	7
OG0002004	0	3	2	2	7
OG0002005	0	7	0	0	7
OG0002006	0	7	0	0	7
OG0002007	0	7	0	0	7
OG0002008	0	7	0	0	7
OG0002009	0	7	0	0	7
OG0002010	0	7	0	0	7
OG0002011	0	7	0	0	7
OG0002012	0	7	0	0	7
OG0002013	0	7	0	0	7
OG0002014	0	1	0	6	7
OG0002015	0	1	6	0	7
OG0002016	0	6	0	1	7
OG0002017	0	6	1	0	7
OG0002018	0	1	0	6	7
OG0002019	0	1	4	2	7
OG0002020	0	0	7	0	7
OG0002021	0	0	7	0	7
OG0002022	0	0	7	0	7
OG0002023	0	0	7	0	7
OG0002024	0	0	5	2	7
OG0002025	0	0	7	0	7
OG0002026	0	0	6	1	7
OG0002027	0	0	7	0	7
OG0002028	0	0	7	0	7
OG0002029	0	0	7	0	7
OG0002030	0	0	7	0	7
OG0002031	0	0	7	0	7
OG0002032	0	0	7	0	7
OG0002033	0	0	7	0	7
OG0002034	0	0	7	0	7
OG0002035	0	0	7	0	7
OG0002036	0	0	7	0	7
OG0002037	0	0	7	0	7
OG0002038	0	0	7	0	7
OG0002039	0	0	7	0	7
OG0002040	0	0	6	1	7
OG0002041	0	0	7	0	7
OG0002042	0	0	6	1	7
OG0002043	0	0	7	0	7
OG0002044	0	0	7	0	7
OG0002045	0	0	7	0	7
OG0002046	0	0	7	0	7
OG0002047	0	0	7	0	7
OG0002048	0	0	7	0	7
OG0002049	0	0	7	0	7
OG0002050	0	0	5	2	7
OG0002051	0	0	7	0	7
OG0002052	0	0	7	0	7
OG0002053	0	0	7	0	7
OG0002054	0	0	6	1	7
OG0002055	0	0	1	6	7
OG0002056	0	0	1	6	7
OG0002057	0	0	1	6	7
OG0002058	0	0	1	6	7
OG0002059	0	0	0	7	7
OG0002060	0	0	0	7	7
OG0002061	0	0	0	7	7
OG0002062	0	0	0	7	7
OG0002063	0	0	0	7	7
OG0002064	0	0	0	7	7
OG0002065	0	0	0	7	7
OG0002066	0	0	0	7	7
OG0002067	0	0	0	7	7
OG0002068	0	0	0	7	7
OG0002069	0	0	0	7	7
OG0002070	0	0	0	7	7
OG0002071	0	0	0	7	7
OG0002072	0	0	0	7	7
OG0002073	0	0	0	7	7
OG0002074	0	0	0	7	7
OG0002075	0	0	0	7	7
OG0002076	0	0	0	7	7
OG0002077	0	0	0	7	7
OG0002078	0	0	0	7	7
OG0002079	0	0	0	7	7
OG0002080	0	0	0	7	7
OG0002081	0	0	0	7	7
OG0002082	0	0	0	7	7
OG0002083	0	0	0	7	7
OG0002084	0	0	0	7	7
OG0002085	0	0	0	7	7
OG0002086	0	0	0	7	7
OG0002087	0	0	0	7	7
OG0002088	0	0	0	7	7
OG0002089	0	0	0	7	7
OG0002090	0	0	0	7	7
OG0002091	0	0	0	7	7
OG0002092	0	0	0	7	7
OG0002093	0	0	0	7	7
OG0002094	0	0	0	7	7
OG0002095	0	0	0	7	7
OG0002096	0	0	0	7	7
OG0002097	0	0	0	7	7
OG0002098	0	0	0	7	7
OG0002099	0	0	0	7	7
OG0002100	0	0	0	7	7
OG0002101	0	0	0	7	7
OG0002102	0	0	0	7	7
OG0002103	0	0	0	7	7
OG0002104	0	0	0	7	7
OG0002105	0	0	0	7	7
OG0002106	0	0	0	7	7
OG0002107	0	0	0	7	7
OG0002108	0	0	0	7	7
OG0002109	0	0	0	7	7
OG0002110	1	1	2	2	6
OG0002111	1	1	1	3	6
OG0002112	6	0	0	0	6
OG0002113	6	0	0	0	6
OG0002114	3	1	1	1	6
OG0002115	2	1	1	2	6
OG0002116	4	2	0	0	6
OG0002117	2	1	2	1	6
OG0002118	2	1	1	2	6
OG0002119	2	0	3	1	6
OG0002120	1	1	3	1	6
OG0002121	1	1	4	0	6
OG0002122	1	1	3	1	6
OG0002123	1	1	4	0	6
OG0002124	1	2	1	2	6
OG0002125	5	0	1	0	6
OG0002126	1	1	4	0	6
OG0002127	2	1	3	0	6
OG0002128	2	0	4	0	6
OG0002129	6	0	0	0	6
OG0002130	3	1	1	1	6
OG0002131	1	3	1	1	6
OG0002132	4	1	1	0	6
OG0002133	1	2	3	0	6
OG0002134	2	2	1	1	6
OG0002135	2	1	1	2	6
OG0002136	2	1	1	2	6
OG0002137	2	2	1	1	6
OG0002138	3	0	3	0	6
OG0002139	3	1	1	1	6
OG0002140	3	2	1	0	6
OG0002141	2	1	1	2	6
OG0002142	3	1	1	1	6
OG0002143	1	1	2	2	6
OG0002144	2	1	1	2	6
OG0002145	2	2	2	0	6
OG0002146	2	1	2	1	6
OG0002147	1	1	1	3	6
OG0002148	2	1	3	0	6
OG0002149	2	2	1	1	6
OG0002150	1	3	0	2	6
OG0002151	2	1	2	1	6
OG0002152	2	2	1	1	6
OG0002153	5	1	0	0	6
OG0002154	2	1	2	1	6
OG0002155	2	2	1	1	6
OG0002156	1	1	1	3	6
OG0002157	2	2	1	1	6
OG0002158	2	2	1	1	6
OG0002159	2	2	2	0	6
OG0002160	4	2	0	0	6
OG0002161	3	1	1	1	6
OG0002162	3	1	1	1	6
OG0002163	1	0	0	5	6
OG0002164	2	1	1	2	6
OG0002165	1	1	2	2	6
OG0002166	1	3	1	1	6
OG0002167	5	1	0	0	6
OG0002168	4	0	2	0	6
OG0002169	2	0	4	0	6
OG0002170	3	2	1	0	6
OG0002171	2	0	3	1	6
OG0002172	3	1	1	1	6
OG0002173	2	1	1	2	6
OG0002174	1	0	5	0	6
OG0002175	3	1	1	1	6
OG0002176	2	2	2	0	6
OG0002177	2	1	0	3	6
OG0002178	2	2	1	1	6
OG0002179	2	3	1	0	6
OG0002180	1	1	1	3	6
OG0002181	2	1	1	2	6
OG0002182	2	2	1	1	6
OG0002183	2	1	0	3	6
OG0002184	3	1	1	1	6
OG0002185	1	2	2	1	6
OG0002186	1	1	1	3	6
OG0002187	2	2	1	1	6
OG0002188	1	1	2	2	6
OG0002189	1	4	1	0	6
OG0002190	2	1	1	2	6
OG0002191	6	0	0	0	6
OG0002192	2	2	1	1	6
OG0002193	2	1	3	0	6
OG0002194	2	2	1	1	6
OG0002195	1	1	1	3	6
OG0002196	3	1	1	1	6
OG0002197	2	1	1	2	6
OG0002198	2	1	2	1	6
OG0002199	5	0	1	0	6
OG0002200	2	2	1	1	6
OG0002201	2	0	2	2	6
OG0002202	1	1	3	1	6
OG0002203	1	1	1	3	6
OG0002204	1	1	3	1	6
OG0002205	1	2	1	2	6
OG0002206	2	1	2	1	6
OG0002207	2	2	1	1	6
OG0002208	2	1	1	2	6
OG0002209	3	1	1	1	6
OG0002210	2	1	2	1	6
OG0002211	3	1	1	1	6
OG0002212	6	0	0	0	6
OG0002213	1	1	1	3	6
OG0002214	2	1	2	1	6
OG0002215	6	0	0	0	6
OG0002216	4	1	1	0	6
OG0002217	2	2	2	0	6
OG0002218	3	0	3	0	6
OG0002219	1	1	1	3	6
OG0002220	2	1	1	2	6
OG0002221	2	2	2	0	6
OG0002222	3	1	1	1	6
OG0002223	1	2	2	1	6
OG0002224	1	1	1	3	6
OG0002225	1	1	1	3	6
OG0002226	1	3	1	1	6
OG0002227	1	1	4	0	6
OG0002228	1	5	0	0	6
OG0002229	3	1	1	1	6
OG0002230	2	3	1	0	6
OG0002231	6	0	0	0	6
OG0002232	3	1	1	1	6
OG0002233	1	1	1	3	6
OG0002234	2	2	1	1	6
OG0002235	3	1	2	0	6
OG0002236	2	1	1	2	6
OG0002237	6	0	0	0	6
OG0002238	2	1	2	1	6
OG0002239	4	0	2	0	6
OG0002240	6	0	0	0	6
OG0002241	1	1	2	2	6
OG0002242	2	1	2	1	6
OG0002243	1	1	1	3	6
OG0002244	2	2	1	1	6
OG0002245	3	1	2	0	6
OG0002246	1	1	2	2	6
OG0002247	2	1	1	2	6
OG0002248	1	1	3	1	6
OG0002249	3	2	1	0	6
OG0002250	4	1	1	0	6
OG0002251	1	1	2	2	6
OG0002252	1	1	1	3	6
OG0002253	1	1	1	3	6
OG0002254	2	2	1	1	6
OG0002255	3	1	1	1	6
OG0002256	4	1	1	0	6
OG0002257	1	1	1	3	6
OG0002258	1	1	1	3	6
OG0002259	2	1	2	1	6
OG0002260	2	2	1	1	6
OG0002261	1	1	2	2	6
OG0002262	2	1	2	1	6
OG0002263	2	2	2	0	6
OG0002264	4	1	1	0	6
OG0002265	1	1	1	3	6
OG0002266	1	1	4	0	6
OG0002267	1	1	4	0	6
OG0002268	1	2	1	2	6
OG0002269	3	2	1	0	6
OG0002270	2	1	1	2	6
OG0002271	1	1	1	3	6
OG0002272	1	1	1	3	6
OG0002273	2	1	2	1	6
OG0002274	3	3	0	0	6
OG0002275	2	1	2	1	6
OG0002276	3	1	1	1	6
OG0002277	3	1	1	1	6
OG0002278	2	1	1	2	6
OG0002279	6	0	0	0	6
OG0002280	6	0	0	0	6
OG0002281	1	1	3	1	6
OG0002282	2	2	1	1	6
OG0002283	1	1	1	3	6
OG0002284	1	1	3	1	6
OG0002285	2	2	2	0	6
OG0002286	1	1	1	3	6
OG0002287	1	1	1	3	6
OG0002288	1	3	1	1	6
OG0002289	1	1	1	3	6
OG0002290	1	2	2	1	6
OG0002291	1	1	1	3	6
OG0002292	2	2	2	0	6
OG0002293	1	1	1	3	6
OG0002294	2	2	2	0	6
OG0002295	1	1	1	3	6
OG0002296	5	0	1	0	6
OG0002297	1	1	1	3	6
OG0002298	1	1	4	0	6
OG0002299	2	2	1	1	6
OG0002300	2	1	1	2	6
OG0002301	1	2	1	2	6
OG0002302	2	1	3	0	6
OG0002303	1	4	0	1	6
OG0002304	2	2	1	1	6
OG0002305	1	1	2	2	6
OG0002306	1	1	1	3	6
OG0002307	1	1	1	3	6
OG0002308	1	1	1	3	6
OG0002309	1	1	1	3	6
OG0002310	2	2	1	1	6
OG0002311	1	1	1	3	6
OG0002312	2	1	2	1	6
OG0002313	2	1	2	1	6
OG0002314	6	0	0	0	6
OG0002315	3	1	1	1	6
OG0002316	4	2	0	0	6
OG0002317	2	1	1	2	6
OG0002318	1	1	1	3	6
OG0002319	2	1	3	0	6
OG0002320	2	2	1	1	6
OG0002321	1	3	2	0	6
OG0002322	1	1	2	2	6
OG0002323	1	1	1	3	6
OG0002324	2	2	1	1	6
OG0002325	2	1	1	2	6
OG0002326	1	2	1	2	6
OG0002327	3	1	1	1	6
OG0002328	1	1	2	2	6
OG0002329	1	1	1	3	6
OG0002330	2	2	2	0	6
OG0002331	1	1	2	2	6
OG0002332	1	1	3	1	6
OG0002333	3	0	2	1	6
OG0002334	2	1	2	1	6
OG0002335	1	3	1	1	6
OG0002336	2	2	1	1	6
OG0002337	1	2	1	2	6
OG0002338	2	1	1	2	6
OG0002339	2	2	1	1	6
OG0002340	3	1	1	1	6
OG0002341	1	1	1	3	6
OG0002342	6	0	0	0	6
OG0002343	3	1	2	0	6
OG0002344	1	3	1	1	6
OG0002345	2	2	2	0	6
OG0002346	4	2	0	0	6
OG0002347	3	1	2	0	6
OG0002348	2	1	1	2	6
OG0002349	3	1	1	1	6
OG0002350	2	2	1	1	6
OG0002351	2	1	1	2	6
OG0002352	1	1	2	2	6
OG0002353	1	2	2	1	6
OG0002354	1	2	2	1	6
OG0002355	3	1	1	1	6
OG0002356	3	1	1	1	6
OG0002357	3	1	1	1	6
OG0002358	3	0	3	0	6
OG0002359	1	1	1	3	6
OG0002360	1	0	5	0	6
OG0002361	1	1	1	3	6
OG0002362	2	1	3	0	6
OG0002363	3	2	1	0	6
OG0002364	1	1	1	3	6
OG0002365	1	1	1	3	6
OG0002366	1	2	1	2	6
OG0002367	2	2	1	1	6
OG0002368	1	1	1	3	6
OG0002369	2	1	1	2	6
OG0002370	1	1	1	3	6
OG0002371	6	0	0	0	6
OG0002372	1	1	1	3	6
OG0002373	6	0	0	0	6
OG0002374	6	0	0	0	6
OG0002375	2	2	2	0	6
OG0002376	2	1	1	2	6
OG0002377	2	2	1	1	6
OG0002378	3	1	1	1	6
OG0002379	2	1	2	1	6
OG0002380	1	3	1	1	6
OG0002381	1	1	1	3	6
OG0002382	1	1	4	0	6
OG0002383	6	0	0	0	6
OG0002384	1	2	3	0	6
OG0002385	1	1	1	3	6
OG0002386	3	1	1	1	6
OG0002387	2	1	2	1	6
OG0002388	6	0	0	0	6
OG0002389	2	2	1	1	6
OG0002390	1	1	2	2	6
OG0002391	1	1	1	3	6
OG0002392	1	1	2	2	6
OG0002393	1	1	1	3	6
OG0002394	2	3	1	0	6
OG0002395	1	3	1	1	6
OG0002396	2	1	2	1	6
OG0002397	2	1	2	1	6
OG0002398	2	0	4	0	6
OG0002399	2	1	3	0	6
OG0002400	2	1	2	1	6
OG0002401	1	1	1	3	6
OG0002402	4	0	2	0	6
OG0002403	2	1	1	2	6
OG0002404	2	1	1	2	6
OG0002405	4	2	0	0	6
OG0002406	2	1	3	0	6
OG0002407	3	1	2	0	6
OG0002408	3	1	1	1	6
OG0002409	1	1	1	3	6
OG0002410	3	1	2	0	6
OG0002411	1	1	3	1	6
OG0002412	2	1	1	2	6
OG0002413	2	1	1	2	6
OG0002414	2	1	3	0	6
OG0002415	1	0	4	1	6
OG0002416	1	1	1	3	6
OG0002417	2	1	3	0	6
OG0002418	4	2	0	0	6
OG0002419	2	1	1	2	6
OG0002420	1	2	2	1	6
OG0002421	2	1	2	1	6
OG0002422	2	1	3	0	6
OG0002423	2	2	1	1	6
OG0002424	1	3	2	0	6
OG0002425	3	0	3	0	6
OG0002426	2	1	1	2	6
OG0002427	1	1	1	3	6
OG0002428	1	1	3	1	6
OG0002429	2	1	2	1	6
OG0002430	2	1	2	1	6
OG0002431	2	1	1	2	6
OG0002432	1	1	1	3	6
OG0002433	2	1	1	2	6
OG0002434	4	0	2	0	6
OG0002435	2	1	2	1	6
OG0002436	1	2	2	1	6
OG0002437	6	0	0	0	6
OG0002438	1	5	0	0	6
OG0002439	1	1	1	3	6
OG0002440	1	1	1	3	6
OG0002441	4	2	0	0	6
OG0002442	5	1	0	0	6
OG0002443	3	1	1	1	6
OG0002444	1	1	4	0	6
OG0002445	1	1	1	3	6
OG0002446	3	1	2	0	6
OG0002447	3	1	1	1	6
OG0002448	1	1	1	3	6
OG0002449	3	1	2	0	6
OG0002450	2	1	1	2	6
OG0002451	1	1	1	3	6
OG0002452	1	1	1	3	6
OG0002453	1	1	1	3	6
OG0002454	1	1	2	2	6
OG0002455	2	1	2	1	6
OG0002456	1	2	2	1	6
OG0002457	2	1	1	2	6
OG0002458	1	0	3	2	6
OG0002459	1	2	2	1	6
OG0002460	1	1	3	1	6
OG0002461	1	1	3	1	6
OG0002462	1	1	2	2	6
OG0002463	1	0	3	2	6
OG0002464	2	1	1	2	6
OG0002465	2	1	2	1	6
OG0002466	2	2	1	1	6
OG0002467	1	4	1	0	6
OG0002468	4	1	1	0	6
OG0002469	2	0	4	0	6
OG0002470	2	1	3	0	6
OG0002471	1	1	4	0	6
OG0002472	1	1	1	3	6
OG0002473	1	2	2	1	6
OG0002474	2	2	1	1	6
OG0002475	2	1	2	1	6
OG0002476	1	2	2	1	6
OG0002477	1	1	1	3	6
OG0002478	6	0	0	0	6
OG0002479	1	1	2	2	6
OG0002480	1	2	3	0	6
OG0002481	1	2	2	1	6
OG0002482	5	1	0	0	6
OG0002483	2	1	2	1	6
OG0002484	6	0	0	0	6
OG0002485	2	3	1	0	6
OG0002486	1	1	1	3	6
OG0002487	1	1	1	3	6
OG0002488	1	3	1	1	6
OG0002489	2	2	2	0	6
OG0002490	1	5	0	0	6
OG0002491	1	2	2	1	6
OG0002492	5	0	1	0	6
OG0002493	3	1	1	1	6
OG0002494	3	2	1	0	6
OG0002495	2	1	3	0	6
OG0002496	2	4	0	0	6
OG0002497	1	1	2	2	6
OG0002498	3	1	2	0	6
OG0002499	3	1	1	1	6
OG0002500	1	1	1	3	6
OG0002501	3	2	1	0	6
OG0002502	1	3	1	1	6
OG0002503	1	4	1	0	6
OG0002504	1	2	2	1	6
OG0002505	3	1	1	1	6
OG0002506	3	3	0	0	6
OG0002507	2	2	1	1	6
OG0002508	2	2	2	0	6
OG0002509	1	1	3	1	6
OG0002510	2	1	1	2	6
OG0002511	1	0	0	5	6
OG0002512	2	1	3	0	6
OG0002513	2	1	2	1	6
OG0002514	3	1	2	0	6
OG0002515	2	1	2	1	6
OG0002516	1	1	1	3	6
OG0002517	1	1	3	1	6
OG0002518	2	1	2	1	6
OG0002519	3	1	2	0	6
OG0002520	1	1	2	2	6
OG0002521	1	1	1	3	6
OG0002522	2	2	1	1	6
OG0002523	1	1	1	3	6
OG0002524	1	2	1	2	6
OG0002525	3	1	1	1	6
OG0002526	1	1	3	1	6
OG0002527	6	0	0	0	6
OG0002528	2	2	2	0	6
OG0002529	2	0	4	0	6
OG0002530	2	3	1	0	6
OG0002531	2	2	1	1	6
OG0002532	5	1	0	0	6
OG0002533	1	1	1	3	6
OG0002534	2	2	1	1	6
OG0002535	3	0	1	2	6
OG0002536	2	1	1	2	6
OG0002537	1	1	4	0	6
OG0002538	1	1	1	3	6
OG0002539	2	1	2	1	6
OG0002540	2	1	1	2	6
OG0002541	2	1	1	2	6
OG0002542	1	1	3	1	6
OG0002543	3	2	1	0	6
OG0002544	2	1	3	0	6
OG0002545	1	5	0	0	6
OG0002546	2	1	2	1	6
OG0002547	2	0	0	4	6
OG0002548	2	1	1	2	6
OG0002549	2	1	2	1	6
OG0002550	1	1	1	3	6
OG0002551	1	5	0	0	6
OG0002552	2	1	1	2	6
OG0002553	1	2	2	1	6
OG0002554	2	2	1	1	6
OG0002555	2	0	4	0	6
OG0002556	1	2	3	0	6
OG0002557	1	4	1	0	6
OG0002558	1	1	2	2	6
OG0002559	1	1	2	2	6
OG0002560	1	3	1	1	6
OG0002561	1	1	2	2	6
OG0002562	1	1	3	1	6
OG0002563	4	1	1	0	6
OG0002564	1	4	1	0	6
OG0002565	1	1	1	3	6
OG0002566	1	1	1	3	6
OG0002567	2	3	1	0	6
OG0002568	4	0	2	0	6
OG0002569	2	2	1	1	6
OG0002570	1	1	2	2	6
OG0002571	1	1	3	1	6
OG0002572	1	1	3	1	6
OG0002573	2	3	1	0	6
OG0002574	2	1	1	2	6
OG0002575	1	1	1	3	6
OG0002576	1	1	3	1	6
OG0002577	2	2	2	0	6
OG0002578	1	4	1	0	6
OG0002579	2	2	1	1	6
OG0002580	1	2	2	1	6
OG0002581	1	2	1	2	6
OG0002582	1	1	2	2	6
OG0002583	3	1	1	1	6
OG0002584	1	2	3	0	6
OG0002585	2	2	1	1	6
OG0002586	4	1	1	0	6
OG0002587	2	2	1	1	6
OG0002588	2	2	2	0	6
OG0002589	2	2	1	1	6
OG0002590	1	1	1	3	6
OG0002591	2	2	1	1	6
OG0002592	1	1	3	1	6
OG0002593	2	4	0	0	6
OG0002594	3	0	3	0	6
OG0002595	1	1	2	2	6
OG0002596	1	1	1	3	6
OG0002597	1	2	2	1	6
OG0002598	2	2	2	0	6
OG0002599	3	1	1	1	6
OG0002600	1	1	2	2	6
OG0002601	1	1	4	0	6
OG0002602	2	1	2	1	6
OG0002603	1	3	1	1	6
OG0002604	2	1	2	1	6
OG0002605	1	1	1	3	6
OG0002606	2	1	2	1	6
OG0002607	3	1	1	1	6
OG0002608	1	1	2	2	6
OG0002609	1	2	3	0	6
OG0002610	1	2	1	2	6
OG0002611	3	1	2	0	6
OG0002612	2	2	1	1	6
OG0002613	2	1	2	1	6
OG0002614	1	3	1	1	6
OG0002615	3	1	1	1	6
OG0002616	2	1	2	1	6
OG0002617	1	2	1	2	6
OG0002618	1	1	3	1	6
OG0002619	1	1	1	3	6
OG0002620	1	1	1	3	6
OG0002621	3	2	1	0	6
OG0002622	1	0	3	2	6
OG0002623	2	2	1	1	6
OG0002624	1	1	3	1	6
OG0002625	1	1	2	2	6
OG0002626	2	1	1	2	6
OG0002627	4	0	2	0	6
OG0002628	2	1	2	1	6
OG0002629	2	1	2	1	6
OG0002630	1	1	3	1	6
OG0002631	1	1	2	2	6
OG0002632	1	0	0	5	6
OG0002633	2	2	1	1	6
OG0002634	2	1	1	2	6
OG0002635	3	1	1	1	6
OG0002636	5	0	1	0	6
OG0002637	1	2	2	1	6
OG0002638	2	1	2	1	6
OG0002639	1	1	1	3	6
OG0002640	1	1	1	3	6
OG0002641	2	1	1	2	6
OG0002642	1	2	1	2	6
OG0002643	2	1	1	2	6
OG0002644	3	1	2	0	6
OG0002645	2	2	2	0	6
OG0002646	1	0	5	0	6
OG0002647	1	2	2	1	6
OG0002648	2	1	1	2	6
OG0002649	1	1	1	3	6
OG0002650	1	1	2	2	6
OG0002651	1	2	2	1	6
OG0002652	2	1	1	2	6
OG0002653	1	1	1	3	6
OG0002654	6	0	0	0	6
OG0002655	1	1	4	0	6
OG0002656	1	1	1	3	6
OG0002657	1	1	1	3	6
OG0002658	1	1	1	3	6
OG0002659	1	1	4	0	6
OG0002660	1	2	1	2	6
OG0002661	2	1	1	2	6
OG0002662	1	1	2	2	6
OG0002663	2	2	1	1	6
OG0002664	2	0	4	0	6
OG0002665	1	2	3	0	6
OG0002666	1	0	5	0	6
OG0002667	2	2	1	1	6
OG0002668	1	5	0	0	6
OG0002669	2	1	1	2	6
OG0002670	1	3	1	1	6
OG0002671	3	1	1	1	6
OG0002672	1	1	2	2	6
OG0002673	2	2	1	1	6
OG0002674	1	1	3	1	6
OG0002675	1	1	2	2	6
OG0002676	1	1	4	0	6
OG0002677	1	1	1	3	6
OG0002678	2	1	1	2	6
OG0002679	1	5	0	0	6
OG0002680	1	1	4	0	6
OG0002681	1	4	0	1	6
OG0002682	1	0	0	5	6
OG0002683	1	1	1	3	6
OG0002684	1	2	2	1	6
OG0002685	1	2	2	1	6
OG0002686	2	2	2	0	6
OG0002687	1	0	5	0	6
OG0002688	1	1	1	3	6
OG0002689	1	2	2	1	6
OG0002690	1	2	2	1	6
OG0002691	1	0	1	4	6
OG0002692	1	1	1	3	6
OG0002693	1	0	0	5	6
OG0002694	3	1	1	1	6
OG0002695	1	1	1	3	6
OG0002696	2	1	2	1	6
OG0002697	1	1	2	2	6
OG0002698	2	1	2	1	6
OG0002699	2	1	2	1	6
OG0002700	1	1	2	2	6
OG0002701	1	2	2	1	6
OG0002702	2	4	0	0	6
OG0002703	0	6	0	0	6
OG0002704	0	6	0	0	6
OG0002705	0	6	0	0	6
OG0002706	0	3	3	0	6
OG0002707	0	6	0	0	6
OG0002708	0	5	1	0	6
OG0002709	0	6	0	0	6
OG0002710	0	6	0	0	6
OG0002711	0	6	0	0	6
OG0002712	0	1	5	0	6
OG0002713	0	4	2	0	6
OG0002714	0	6	0	0	6
OG0002715	0	6	0	0	6
OG0002716	0	2	4	0	6
OG0002717	0	6	0	0	6
OG0002718	0	6	0	0	6
OG0002719	0	6	0	0	6
OG0002720	0	1	1	4	6
OG0002721	0	6	0	0	6
OG0002722	0	1	0	5	6
OG0002723	0	6	0	0	6
OG0002724	0	1	3	2	6
OG0002725	0	1	0	5	6
OG0002726	0	6	0	0	6
OG0002727	0	6	0	0	6
OG0002728	0	6	0	0	6
OG0002729	0	3	3	0	6
OG0002730	0	6	0	0	6
OG0002731	0	6	0	0	6
OG0002732	0	4	2	0	6
OG0002733	0	5	1	0	6
OG0002734	0	1	5	0	6
OG0002735	0	1	5	0	6
OG0002736	0	4	1	1	6
OG0002737	0	6	0	0	6
OG0002738	0	1	0	5	6
OG0002739	0	0	6	0	6
OG0002740	0	0	6	0	6
OG0002741	0	0	6	0	6
OG0002742	0	0	6	0	6
OG0002743	0	0	6	0	6
OG0002744	0	0	6	0	6
OG0002745	0	0	6	0	6
OG0002746	0	0	6	0	6
OG0002747	0	0	6	0	6
OG0002748	0	0	6	0	6
OG0002749	0	0	6	0	6
OG0002750	0	0	6	0	6
OG0002751	0	0	6	0	6
OG0002752	0	0	6	0	6
OG0002753	0	0	6	0	6
OG0002754	0	0	5	1	6
OG0002755	0	0	6	0	6
OG0002756	0	0	6	0	6
OG0002757	0	0	6	0	6
OG0002758	0	0	6	0	6
OG0002759	0	0	1	5	6
OG0002760	0	0	5	1	6
OG0002761	0	0	6	0	6
OG0002762	0	0	2	4	6
OG0002763	0	0	6	0	6
OG0002764	0	0	6	0	6
OG0002765	0	0	6	0	6
OG0002766	0	0	6	0	6
OG0002767	0	0	3	3	6
OG0002768	0	0	1	5	6
OG0002769	0	0	6	0	6
OG0002770	0	0	6	0	6
OG0002771	0	0	2	4	6
OG0002772	0	0	6	0	6
OG0002773	0	0	6	0	6
OG0002774	0	0	6	0	6
OG0002775	0	0	6	0	6
OG0002776	0	0	3	3	6
OG0002777	0	0	1	5	6
OG0002778	0	0	6	0	6
OG0002779	0	0	6	0	6
OG0002780	0	0	6	0	6
OG0002781	0	0	6	0	6
OG0002782	0	0	6	0	6
OG0002783	0	0	6	0	6
OG0002784	0	0	6	0	6
OG0002785	0	0	6	0	6
OG0002786	0	0	1	5	6
OG0002787	0	0	1	5	6
OG0002788	0	0	0	6	6
OG0002789	0	0	0	6	6
OG0002790	0	0	0	6	6
OG0002791	0	0	0	6	6
OG0002792	0	0	0	6	6
OG0002793	0	0	0	6	6
OG0002794	0	0	0	6	6
OG0002795	0	0	0	6	6
OG0002796	0	0	0	6	6
OG0002797	0	0	0	6	6
OG0002798	0	0	0	6	6
OG0002799	0	0	0	6	6
OG0002800	0	0	0	6	6
OG0002801	0	0	0	6	6
OG0002802	0	0	0	6	6
OG0002803	0	0	0	6	6
OG0002804	0	0	0	6	6
OG0002805	0	0	0	6	6
OG0002806	0	0	0	6	6
OG0002807	0	0	0	6	6
OG0002808	0	0	0	6	6
OG0002809	0	0	0	6	6
OG0002810	0	0	0	6	6
OG0002811	0	0	0	6	6
OG0002812	0	0	0	6	6
OG0002813	0	0	0	6	6
OG0002814	0	0	0	6	6
OG0002815	0	0	0	6	6
OG0002816	0	0	0	6	6
OG0002817	0	0	0	6	6
OG0002818	0	0	0	6	6
OG0002819	0	0	0	6	6
OG0002820	0	0	0	6	6
OG0002821	0	0	0	6	6
OG0002822	0	0	0	6	6
OG0002823	0	0	0	6	6
OG0002824	0	0	0	6	6
OG0002825	0	0	0	6	6
OG0002826	0	0	0	6	6
OG0002827	0	0	0	6	6
OG0002828	0	0	0	6	6
OG0002829	0	0	0	6	6
OG0002830	0	0	0	6	6
OG0002831	0	0	0	6	6
OG0002832	0	0	0	6	6
OG0002833	0	0	0	6	6
OG0002834	0	0	0	6	6
OG0002835	0	0	0	6	6
OG0002836	0	0	0	6	6
OG0002837	0	0	0	6	6
OG0002838	0	0	0	6	6
OG0002839	0	0	0	6	6
OG0002840	0	0	0	6	6
OG0002841	0	0	0	6	6
OG0002842	0	0	0	6	6
OG0002843	0	0	0	6	6
OG0002844	0	0	0	6	6
OG0002845	0	0	0	6	6
OG0002846	0	0	0	6	6
OG0002847	0	0	0	6	6
OG0002848	0	0	0	6	6
OG0002849	0	0	0	6	6
OG0002850	2	1	1	1	5
OG0002851	2	1	1	1	5
OG0002852	1	1	2	1	5
OG0002853	1	2	1	1	5
OG0002854	2	1	1	1	5
OG0002855	2	1	1	1	5
OG0002856	1	1	2	1	5
OG0002857	2	1	1	1	5
OG0002858	3	2	0	0	5
OG0002859	1	1	2	1	5
OG0002860	1	2	1	1	5
OG0002861	2	1	1	1	5
OG0002862	4	0	1	0	5
OG0002863	2	1	1	1	5
OG0002864	1	1	1	2	5
OG0002865	2	1	1	1	5
OG0002866	2	1	1	1	5
OG0002867	1	2	1	1	5
OG0002868	2	1	1	1	5
OG0002869	1	1	2	1	5
OG0002870	1	1	2	1	5
OG0002871	1	4	0	0	5
OG0002872	1	1	1	2	5
OG0002873	1	1	3	0	5
OG0002874	2	1	1	1	5
OG0002875	3	1	1	0	5
OG0002876	5	0	0	0	5
OG0002877	1	4	0	0	5
OG0002878	2	1	1	1	5
OG0002879	2	1	1	1	5
OG0002880	1	1	2	1	5
OG0002881	2	1	1	1	5
OG0002882	1	1	2	1	5
OG0002883	2	1	1	1	5
OG0002884	2	1	1	1	5
OG0002885	1	1	1	2	5
OG0002886	1	0	0	4	5
OG0002887	2	1	1	1	5
OG0002888	1	2	1	1	5
OG0002889	3	0	2	0	5
OG0002890	1	1	2	1	5
OG0002891	2	2	1	0	5
OG0002892	5	0	0	0	5
OG0002893	2	3	0	0	5
OG0002894	1	2	1	1	5
OG0002895	2	1	1	1	5
OG0002896	2	2	1	0	5
OG0002897	1	1	1	2	5
OG0002898	1	1	2	1	5
OG0002899	2	1	1	1	5
OG0002900	2	1	1	1	5
OG0002901	1	1	1	2	5
OG0002902	1	1	2	1	5
OG0002903	1	1	1	2	5
OG0002904	2	1	1	1	5
OG0002905	1	1	1	2	5
OG0002906	4	0	1	0	5
OG0002907	1	1	1	2	5
OG0002908	1	2	1	1	5
OG0002909	1	1	3	0	5
OG0002910	2	2	1	0	5
OG0002911	2	1	1	1	5
OG0002912	2	1	1	1	5
OG0002913	2	1	1	1	5
OG0002914	3	1	1	0	5
OG0002915	2	2	1	0	5
OG0002916	1	1	1	2	5
OG0002917	1	1	2	1	5
OG0002918	1	2	1	1	5
OG0002919	2	1	1	1	5
OG0002920	2	1	1	1	5
OG0002921	1	1	3	0	5
OG0002922	1	1	2	1	5
OG0002923	1	1	2	1	5
OG0002924	2	1	1	1	5
OG0002925	2	1	1	1	5
OG0002926	1	2	1	1	5
OG0002927	2	1	1	1	5
OG0002928	1	0	0	4	5
OG0002929	1	1	2	1	5
OG0002930	1	1	2	1	5
OG0002931	2	1	1	1	5
OG0002932	1	1	2	1	5
OG0002933	1	1	3	0	5
OG0002934	2	1	1	1	5
OG0002935	1	2	1	1	5
OG0002936	3	1	1	0	5
OG0002937	5	0	0	0	5
OG0002938	2	1	1	1	5
OG0002939	1	1	1	2	5
OG0002940	1	1	1	2	5
OG0002941	5	0	0	0	5
OG0002942	1	1	1	2	5
OG0002943	1	1	1	2	5
OG0002944	1	1	1	2	5
OG0002945	3	1	1	0	5
OG0002946	1	1	3	0	5
OG0002947	2	1	1	1	5
OG0002948	2	1	1	1	5
OG0002949	1	1	1	2	5
OG0002950	5	0	0	0	5
OG0002951	2	1	1	1	5
OG0002952	2	1	1	1	5
OG0002953	1	1	2	1	5
OG0002954	1	1	2	1	5
OG0002955	3	1	1	0	5
OG0002956	2	1	1	1	5
OG0002957	2	1	1	1	5
OG0002958	2	1	1	1	5
OG0002959	2	1	1	1	5
OG0002960	2	1	1	1	5
OG0002961	2	1	1	1	5
OG0002962	2	1	1	1	5
OG0002963	5	0	0	0	5
OG0002964	2	1	1	1	5
OG0002965	1	1	1	2	5
OG0002966	3	1	1	0	5
OG0002967	5	0	0	0	5
OG0002968	1	1	2	1	5
OG0002969	5	0	0	0	5
OG0002970	1	1	3	0	5
OG0002971	1	1	1	2	5
OG0002972	2	1	1	1	5
OG0002973	3	1	1	0	5
OG0002974	2	1	1	1	5
OG0002975	2	2	1	0	5
OG0002976	1	2	1	1	5
OG0002977	1	1	1	2	5
OG0002978	1	2	1	1	5
OG0002979	5	0	0	0	5
OG0002980	2	1	1	1	5
OG0002981	1	3	1	0	5
OG0002982	1	1	2	1	5
OG0002983	2	1	1	1	5
OG0002984	2	3	0	0	5
OG0002985	1	1	1	2	5
OG0002986	5	0	0	0	5
OG0002987	1	1	2	1	5
OG0002988	2	1	1	1	5
OG0002989	3	1	1	0	5
OG0002990	2	1	1	1	5
OG0002991	2	1	1	1	5
OG0002992	2	1	1	1	5
OG0002993	2	1	1	1	5
OG0002994	2	1	1	1	5
OG0002995	2	1	1	1	5
OG0002996	2	1	1	1	5
OG0002997	2	1	1	1	5
OG0002998	2	1	1	1	5
OG0002999	1	2	1	1	5
OG0003000	2	1	1	1	5
OG0003001	2	1	2	0	5
OG0003002	2	1	1	1	5
OG0003003	2	3	0	0	5
OG0003004	2	1	1	1	5
OG0003005	1	1	2	1	5
OG0003006	1	2	1	1	5
OG0003007	1	1	2	1	5
OG0003008	2	1	1	1	5
OG0003009	2	1	1	1	5
OG0003010	2	2	1	0	5
OG0003011	2	1	1	1	5
OG0003012	2	1	1	1	5
OG0003013	1	2	1	1	5
OG0003014	2	1	1	1	5
OG0003015	2	1	1	1	5
OG0003016	1	1	2	1	5
OG0003017	3	1	1	0	5
OG0003018	2	1	1	1	5
OG0003019	2	1	1	1	5
OG0003020	5	0	0	0	5
OG0003021	2	3	0	0	5
OG0003022	2	1	1	1	5
OG0003023	5	0	0	0	5
OG0003024	1	0	3	1	5
OG0003025	1	1	2	1	5
OG0003026	2	1	1	1	5
OG0003027	1	1	1	2	5
OG0003028	1	1	1	2	5
OG0003029	2	1	1	1	5
OG0003030	1	1	3	0	5
OG0003031	1	1	2	1	5
OG0003032	1	1	2	1	5
OG0003033	1	2	1	1	5
OG0003034	2	1	1	1	5
OG0003035	2	1	1	1	5
OG0003036	2	1	1	1	5
OG0003037	2	1	1	1	5
OG0003038	1	1	2	1	5
OG0003039	2	1	1	1	5
OG0003040	2	0	0	3	5
OG0003041	1	1	1	2	5
OG0003042	2	1	1	1	5
OG0003043	1	1	2	1	5
OG0003044	1	1	1	2	5
OG0003045	1	1	1	2	5
OG0003046	2	1	1	1	5
OG0003047	1	1	1	2	5
OG0003048	2	1	1	1	5
OG0003049	1	1	2	1	5
OG0003050	2	1	2	0	5
OG0003051	1	1	1	2	5
OG0003052	2	1	1	1	5
OG0003053	1	1	2	1	5
OG0003054	1	1	2	1	5
OG0003055	1	1	1	2	5
OG0003056	1	2	1	1	5
OG0003057	1	1	1	2	5
OG0003058	1	1	2	1	5
OG0003059	5	0	0	0	5
OG0003060	1	1	2	1	5
OG0003061	1	1	1	2	5
OG0003062	1	1	2	1	5
OG0003063	2	1	1	1	5
OG0003064	2	1	1	1	5
OG0003065	1	1	1	2	5
OG0003066	1	1	1	2	5
OG0003067	1	1	1	2	5
OG0003068	2	1	1	1	5
OG0003069	2	1	1	1	5
OG0003070	2	1	1	1	5
OG0003071	2	2	1	0	5
OG0003072	2	1	1	1	5
OG0003073	2	1	1	1	5
OG0003074	1	1	1	2	5
OG0003075	4	1	0	0	5
OG0003076	2	1	1	1	5
OG0003077	3	1	1	0	5
OG0003078	1	2	1	1	5
OG0003079	1	1	1	2	5
OG0003080	2	1	1	1	5
OG0003081	1	1	2	1	5
OG0003082	2	1	1	1	5
OG0003083	1	1	2	1	5
OG0003084	4	1	0	0	5
OG0003085	1	1	1	2	5
OG0003086	2	1	1	1	5
OG0003087	1	1	2	1	5
OG0003088	1	1	1	2	5
OG0003089	3	1	1	0	5
OG0003090	1	1	1	2	5
OG0003091	1	1	2	1	5
OG0003092	1	1	2	1	5
OG0003093	2	1	1	1	5
OG0003094	1	1	1	2	5
OG0003095	1	2	2	0	5
OG0003096	3	2	0	0	5
OG0003097	3	2	0	0	5
OG0003098	2	1	1	1	5
OG0003099	1	2	1	1	5
OG0003100	2	1	1	1	5
OG0003101	1	2	1	1	5
OG0003102	1	0	0	4	5
OG0003103	3	1	1	0	5
OG0003104	2	1	1	1	5
OG0003105	2	1	1	1	5
OG0003106	2	1	1	1	5
OG0003107	1	1	1	2	5
OG0003108	1	1	1	2	5
OG0003109	1	1	2	1	5
OG0003110	1	1	2	1	5
OG0003111	2	1	1	1	5
OG0003112	2	2	1	0	5
OG0003113	1	1	2	1	5
OG0003114	1	0	1	3	5
OG0003115	1	1	2	1	5
OG0003116	1	1	1	2	5
OG0003117	1	2	1	1	5
OG0003118	1	1	1	2	5
OG0003119	2	1	1	1	5
OG0003120	3	0	2	0	5
OG0003121	1	1	1	2	5
OG0003122	2	1	1	1	5
OG0003123	4	0	1	0	5
OG0003124	1	2	1	1	5
OG0003125	1	1	1	2	5
OG0003126	2	1	1	1	5
OG0003127	2	1	1	1	5
OG0003128	2	1	1	1	5
OG0003129	2	1	1	1	5
OG0003130	2	1	1	1	5
OG0003131	3	2	0	0	5
OG0003132	2	1	1	1	5
OG0003133	2	2	1	0	5
OG0003134	1	1	2	1	5
OG0003135	2	1	1	1	5
OG0003136	2	1	2	0	5
OG0003137	3	1	0	1	5
OG0003138	2	1	1	1	5
OG0003139	1	1	1	2	5
OG0003140	2	1	1	1	5
OG0003141	2	1	1	1	5
OG0003142	2	1	1	1	5
OG0003143	2	1	1	1	5
OG0003144	2	1	1	1	5
OG0003145	2	1	1	1	5
OG0003146	5	0	0	0	5
OG0003147	4	0	1	0	5
OG0003148	5	0	0	0	5
OG0003149	2	1	1	1	5
OG0003150	1	2	1	1	5
OG0003151	1	1	1	2	5
OG0003152	3	1	1	0	5
OG0003153	1	1	1	2	5
OG0003154	2	1	1	1	5
OG0003155	1	1	1	2	5
OG0003156	1	1	1	2	5
OG0003157	2	1	2	0	5
OG0003158	1	1	1	2	5
OG0003159	2	1	1	1	5
OG0003160	2	1	1	1	5
OG0003161	2	1	1	1	5
OG0003162	1	1	1	2	5
OG0003163	2	1	1	1	5
OG0003164	2	1	1	1	5
OG0003165	1	1	2	1	5
OG0003166	1	1	2	1	5
OG0003167	2	2	1	0	5
OG0003168	1	1	2	1	5
OG0003169	2	1	1	1	5
OG0003170	2	1	1	1	5
OG0003171	2	1	1	1	5
OG0003172	1	1	1	2	5
OG0003173	5	0	0	0	5
OG0003174	2	1	1	1	5
OG0003175	4	0	1	0	5
OG0003176	2	3	0	0	5
OG0003177	2	1	1	1	5
OG0003178	2	1	1	1	5
OG0003179	2	1	1	1	5
OG0003180	1	1	1	2	5
OG0003181	1	1	1	2	5
OG0003182	2	1	1	1	5
OG0003183	1	1	1	2	5
OG0003184	3	1	1	0	5
OG0003185	3	0	2	0	5
OG0003186	2	1	1	1	5
OG0003187	1	1	1	2	5
OG0003188	2	1	1	1	5
OG0003189	1	1	1	2	5
OG0003190	2	1	1	1	5
OG0003191	1	1	1	2	5
OG0003192	2	1	1	1	5
OG0003193	1	1	1	2	5
OG0003194	2	1	1	1	5
OG0003195	2	1	1	1	5
OG0003196	2	1	1	1	5
OG0003197	2	1	1	1	5
OG0003198	5	0	0	0	5
OG0003199	3	1	1	0	5
OG0003200	2	1	1	1	5
OG0003201	2	1	1	1	5
OG0003202	2	1	1	1	5
OG0003203	2	1	1	1	5
OG0003204	1	1	1	2	5
OG0003205	3	1	1	0	5
OG0003206	2	1	2	0	5
OG0003207	1	1	2	1	5
OG0003208	1	1	3	0	5
OG0003209	1	4	0	0	5
OG0003210	1	1	2	1	5
OG0003211	1	2	1	1	5
OG0003212	2	1	1	1	5
OG0003213	1	1	3	0	5
OG0003214	1	1	2	1	5
OG0003215	1	1	2	1	5
OG0003216	2	1	1	1	5
OG0003217	1	2	1	1	5
OG0003218	1	1	1	2	5
OG0003219	2	1	1	1	5
OG0003220	4	1	0	0	5
OG0003221	4	1	0	0	5
OG0003222	1	1	1	2	5
OG0003223	2	1	1	1	5
OG0003224	2	1	1	1	5
OG0003225	2	1	1	1	5
OG0003226	1	1	1	2	5
OG0003227	2	1	1	1	5
OG0003228	1	1	2	1	5
OG0003229	3	1	1	0	5
OG0003230	1	1	2	1	5
OG0003231	1	1	2	1	5
OG0003232	2	1	1	1	5
OG0003233	2	1	1	1	5
OG0003234	2	1	1	1	5
OG0003235	2	1	1	1	5
OG0003236	2	2	1	0	5
OG0003237	4	0	1	0	5
OG0003238	1	1	3	0	5
OG0003239	2	1	1	1	5
OG0003240	2	1	1	1	5
OG0003241	1	1	2	1	5
OG0003242	1	1	1	2	5
OG0003243	1	1	1	2	5
OG0003244	1	1	1	2	5
OG0003245	1	1	1	2	5
OG0003246	1	3	1	0	5
OG0003247	2	1	1	1	5
OG0003248	2	1	1	1	5
OG0003249	2	1	1	1	5
OG0003250	1	2	1	1	5
OG0003251	1	1	1	2	5
OG0003252	1	1	1	2	5
OG0003253	1	1	1	2	5
OG0003254	1	1	1	2	5
OG0003255	1	1	1	2	5
OG0003256	2	1	1	1	5
OG0003257	2	1	1	1	5
OG0003258	3	1	1	0	5
OG0003259	2	1	1	1	5
OG0003260	1	2	2	0	5
OG0003261	2	1	2	0	5
OG0003262	2	1	1	1	5
OG0003263	2	1	1	1	5
OG0003264	2	1	1	1	5
OG0003265	2	1	1	1	5
OG0003266	1	1	2	1	5
OG0003267	1	1	1	2	5
OG0003268	2	1	1	1	5
OG0003269	1	1	1	2	5
OG0003270	2	1	1	1	5
OG0003271	2	1	1	1	5
OG0003272	2	1	1	1	5
OG0003273	2	1	1	1	5
OG0003274	2	1	1	1	5
OG0003275	2	1	2	0	5
OG0003276	1	2	1	1	5
OG0003277	1	1	2	1	5
OG0003278	2	1	1	1	5
OG0003279	5	0	0	0	5
OG0003280	2	1	1	1	5
OG0003281	1	1	2	1	5
OG0003282	5	0	0	0	5
OG0003283	1	1	1	2	5
OG0003284	2	1	1	1	5
OG0003285	2	1	1	1	5
OG0003286	2	1	2	0	5
OG0003287	1	1	2	1	5
OG0003288	2	2	1	0	5
OG0003289	1	1	1	2	5
OG0003290	2	1	1	1	5
OG0003291	1	1	2	1	5
OG0003292	2	1	1	1	5
OG0003293	2	1	1	1	5
OG0003294	1	1	1	2	5
OG0003295	2	2	1	0	5
OG0003296	2	1	2	0	5
OG0003297	2	1	1	1	5
OG0003298	2	1	1	1	5
OG0003299	5	0	0	0	5
OG0003300	1	1	1	2	5
OG0003301	3	0	2	0	5
OG0003302	1	1	2	1	5
OG0003303	2	1	1	1	5
OG0003304	2	1	1	1	5
OG0003305	1	1	2	1	5
OG0003306	1	2	1	1	5
OG0003307	1	1	2	1	5
OG0003308	1	1	1	2	5
OG0003309	1	2	1	1	5
OG0003310	2	2	1	0	5
OG0003311	2	1	1	1	5
OG0003312	1	1	2	1	5
OG0003313	2	1	1	1	5
OG0003314	2	0	3	0	5
OG0003315	2	1	1	1	5
OG0003316	2	1	1	1	5
OG0003317	1	1	1	2	5
OG0003318	2	1	2	0	5
OG0003319	2	1	1	1	5
OG0003320	1	1	1	2	5
OG0003321	1	2	1	1	5
OG0003322	1	2	2	0	5
OG0003323	5	0	0	0	5
OG0003324	1	1	2	1	5
OG0003325	1	1	1	2	5
OG0003326	1	1	2	1	5
OG0003327	2	1	1	1	5
OG0003328	1	1	2	1	5
OG0003329	1	1	1	2	5
OG0003330	2	1	1	1	5
OG0003331	2	1	1	1	5
OG0003332	2	1	1	1	5
OG0003333	1	1	2	1	5
OG0003334	1	1	1	2	5
OG0003335	5	0	0	0	5
OG0003336	1	1	2	1	5
OG0003337	1	1	1	2	5
OG0003338	1	1	3	0	5
OG0003339	5	0	0	0	5
OG0003340	5	0	0	0	5
OG0003341	1	1	1	2	5
OG0003342	1	1	1	2	5
OG0003343	2	1	1	1	5
OG0003344	1	1	1	2	5
OG0003345	5	0	0	0	5
OG0003346	5	0	0	0	5
OG0003347	5	0	0	0	5
OG0003348	3	0	0	2	5
OG0003349	3	1	1	0	5
OG0003350	2	2	1	0	5
OG0003351	3	1	1	0	5
OG0003352	2	1	1	1	5
OG0003353	1	1	2	1	5
OG0003354	1	1	2	1	5
OG0003355	3	2	0	0	5
OG0003356	1	1	1	2	5
OG0003357	1	1	2	1	5
OG0003358	5	0	0	0	5
OG0003359	2	1	1	1	5
OG0003360	2	1	1	1	5
OG0003361	1	2	1	1	5
OG0003362	2	1	1	1	5
OG0003363	2	2	1	0	5
OG0003364	1	1	1	2	5
OG0003365	1	1	1	2	5
OG0003366	1	1	2	1	5
OG0003367	2	2	1	0	5
OG0003368	1	1	1	2	5
OG0003369	1	1	1	2	5
OG0003370	1	1	1	2	5
OG0003371	1	1	1	2	5
OG0003372	1	1	1	2	5
OG0003373	1	1	1	2	5
OG0003374	1	1	1	2	5
OG0003375	4	1	0	0	5
OG0003376	1	1	2	1	5
OG0003377	1	1	2	1	5
OG0003378	1	1	2	1	5
OG0003379	2	1	2	0	5
OG0003380	1	1	2	1	5
OG0003381	2	1	1	1	5
OG0003382	1	2	1	1	5
OG0003383	2	1	1	1	5
OG0003384	1	3	1	0	5
OG0003385	1	4	0	0	5
OG0003386	1	1	2	1	5
OG0003387	2	2	1	0	5
OG0003388	2	1	1	1	5
OG0003389	1	2	1	1	5
OG0003390	1	1	1	2	5
OG0003391	2	1	1	1	5
OG0003392	1	1	3	0	5
OG0003393	2	1	1	1	5
OG0003394	2	1	1	1	5
OG0003395	2	1	1	1	5
OG0003396	1	2	1	1	5
OG0003397	2	2	1	0	5
OG0003398	1	1	1	2	5
OG0003399	1	1	2	1	5
OG0003400	2	1	1	1	5
OG0003401	1	1	2	1	5
OG0003402	2	3	0	0	5
OG0003403	1	1	3	0	5
OG0003404	1	1	2	1	5
OG0003405	1	1	2	1	5
OG0003406	2	1	1	1	5
OG0003407	1	1	2	1	5
OG0003408	1	2	1	1	5
OG0003409	2	1	1	1	5
OG0003410	2	1	2	0	5
OG0003411	2	1	1	1	5
OG0003412	2	1	1	1	5
OG0003413	5	0	0	0	5
OG0003414	1	1	2	1	5
OG0003415	2	1	1	1	5
OG0003416	1	1	2	1	5
OG0003417	2	1	1	1	5
OG0003418	5	0	0	0	5
OG0003419	2	2	1	0	5
OG0003420	1	1	2	1	5
OG0003421	2	1	1	1	5
OG0003422	5	0	0	0	5
OG0003423	1	2	1	1	5
OG0003424	1	1	1	2	5
OG0003425	1	1	2	1	5
OG0003426	5	0	0	0	5
OG0003427	1	1	1	2	5
OG0003428	1	1	1	2	5
OG0003429	2	1	1	1	5
OG0003430	2	1	1	1	5
OG0003431	1	1	1	2	5
OG0003432	2	1	1	1	5
OG0003433	2	1	1	1	5
OG0003434	3	0	2	0	5
OG0003435	2	1	2	0	5
OG0003436	2	2	1	0	5
OG0003437	1	1	2	1	5
OG0003438	2	1	1	1	5
OG0003439	2	1	1	1	5
OG0003440	1	1	1	2	5
OG0003441	2	2	1	0	5
OG0003442	2	1	1	1	5
OG0003443	3	0	2	0	5
OG0003444	1	1	1	2	5
OG0003445	1	3	1	0	5
OG0003446	2	1	1	1	5
OG0003447	2	1	1	1	5
OG0003448	2	1	1	1	5
OG0003449	2	1	1	1	5
OG0003450	1	2	1	1	5
OG0003451	2	1	1	1	5
OG0003452	1	1	2	1	5
OG0003453	1	1	2	1	5
OG0003454	1	2	2	0	5
OG0003455	1	1	2	1	5
OG0003456	1	1	1	2	5
OG0003457	2	1	1	1	5
OG0003458	2	1	1	1	5
OG0003459	2	1	1	1	5
OG0003460	4	0	1	0	5
OG0003461	2	1	1	1	5
OG0003462	2	1	1	1	5
OG0003463	2	1	1	1	5
OG0003464	2	1	1	1	5
OG0003465	2	1	1	1	5
OG0003466	2	1	1	1	5
OG0003467	2	1	1	1	5
OG0003468	1	1	1	2	5
OG0003469	2	2	1	0	5
OG0003470	2	1	1	1	5
OG0003471	2	1	1	1	5
OG0003472	1	1	2	1	5
OG0003473	2	1	1	1	5
OG0003474	2	1	2	0	5
OG0003475	2	1	1	1	5
OG0003476	1	1	2	1	5
OG0003477	1	1	1	2	5
OG0003478	2	1	1	1	5
OG0003479	1	1	1	2	5
OG0003480	2	2	1	0	5
OG0003481	2	1	1	1	5
OG0003482	1	1	1	2	5
OG0003483	2	1	1	1	5
OG0003484	2	1	1	1	5
OG0003485	1	1	1	2	5
OG0003486	1	1	1	2	5
OG0003487	5	0	0	0	5
OG0003488	1	1	1	2	5
OG0003489	1	1	1	2	5
OG0003490	1	1	1	2	5
OG0003491	2	1	1	1	5
OG0003492	2	1	1	1	5
OG0003493	2	2	1	0	5
OG0003494	2	1	1	1	5
OG0003495	2	1	1	1	5
OG0003496	1	1	1	2	5
OG0003497	1	1	2	1	5
OG0003498	1	1	1	2	5
OG0003499	1	1	1	2	5
OG0003500	1	1	1	2	5
OG0003501	1	1	1	2	5
OG0003502	2	2	0	1	5
OG0003503	1	1	1	2	5
OG0003504	2	2	1	0	5
OG0003505	1	1	2	1	5
OG0003506	2	1	1	1	5
OG0003507	2	2	1	0	5
OG0003508	1	1	1	2	5
OG0003509	1	1	3	0	5
OG0003510	1	1	2	1	5
OG0003511	1	1	2	1	5
OG0003512	1	2	1	1	5
OG0003513	1	1	2	1	5
OG0003514	1	1	1	2	5
OG0003515	3	2	0	0	5
OG0003516	5	0	0	0	5
OG0003517	2	1	1	1	5
OG0003518	1	2	1	1	5
OG0003519	1	2	1	1	5
OG0003520	1	1	1	2	5
OG0003521	2	1	1	1	5
OG0003522	2	1	1	1	5
OG0003523	2	1	1	1	5
OG0003524	2	2	1	0	5
OG0003525	1	1	3	0	5
OG0003526	2	1	2	0	5
OG0003527	1	1	1	2	5
OG0003528	2	1	1	1	5
OG0003529	1	1	2	1	5
OG0003530	2	1	1	1	5
OG0003531	1	2	2	0	5
OG0003532	1	1	1	2	5
OG0003533	1	1	2	1	5
OG0003534	1	1	1	2	5
OG0003535	2	1	1	1	5
OG0003536	2	1	1	1	5
OG0003537	1	1	1	2	5
OG0003538	5	0	0	0	5
OG0003539	2	1	1	1	5
OG0003540	2	1	1	1	5
OG0003541	1	2	1	1	5
OG0003542	2	1	1	1	5
OG0003543	2	1	2	0	5
OG0003544	1	1	2	1	5
OG0003545	1	2	1	1	5
OG0003546	2	1	1	1	5
OG0003547	2	2	1	0	5
OG0003548	2	1	1	1	5
OG0003549	2	1	1	1	5
OG0003550	2	1	1	1	5
OG0003551	1	1	2	1	5
OG0003552	1	2	2	0	5
OG0003553	1	2	1	1	5
OG0003554	4	0	1	0	5
OG0003555	1	1	2	1	5
OG0003556	2	1	1	1	5
OG0003557	2	1	2	0	5
OG0003558	2	1	2	0	5
OG0003559	1	1	2	1	5
OG0003560	1	1	2	1	5
OG0003561	2	1	1	1	5
OG0003562	2	1	1	1	5
OG0003563	1	1	2	1	5
OG0003564	1	1	1	2	5
OG0003565	1	1	2	1	5
OG0003566	2	1	1	1	5
OG0003567	1	2	1	1	5
OG0003568	2	1	1	1	5
OG0003569	3	1	0	1	5
OG0003570	2	1	1	1	5
OG0003571	1	1	1	2	5
OG0003572	1	1	1	2	5
OG0003573	1	1	2	1	5
OG0003574	1	1	1	2	5
OG0003575	2	1	1	1	5
OG0003576	1	1	2	1	5
OG0003577	1	1	2	1	5
OG0003578	1	1	1	2	5
OG0003579	3	1	1	0	5
OG0003580	1	2	1	1	5
OG0003581	1	1	1	2	5
OG0003582	1	1	2	1	5
OG0003583	1	1	2	1	5
OG0003584	1	1	1	2	5
OG0003585	1	1	2	1	5
OG0003586	2	1	1	1	5
OG0003587	1	1	2	1	5
OG0003588	4	1	0	0	5
OG0003589	1	3	1	0	5
OG0003590	2	1	1	1	5
OG0003591	1	1	1	2	5
OG0003592	2	1	1	1	5
OG0003593	1	1	2	1	5
OG0003594	1	1	2	1	5
OG0003595	1	1	1	2	5
OG0003596	1	1	1	2	5
OG0003597	2	2	1	0	5
OG0003598	1	1	2	1	5
OG0003599	1	1	2	1	5
OG0003600	2	1	1	1	5
OG0003601	1	1	2	1	5
OG0003602	2	1	1	1	5
OG0003603	5	0	0	0	5
OG0003604	1	0	3	1	5
OG0003605	2	1	1	1	5
OG0003606	1	2	1	1	5
OG0003607	2	0	2	1	5
OG0003608	2	0	3	0	5
OG0003609	1	1	1	2	5
OG0003610	2	1	1	1	5
OG0003611	2	2	1	0	5
OG0003612	2	1	1	1	5
OG0003613	2	2	1	0	5
OG0003614	2	1	1	1	5
OG0003615	1	2	1	1	5
OG0003616	1	1	2	1	5
OG0003617	2	1	1	1	5
OG0003618	2	1	1	1	5
OG0003619	1	1	2	1	5
OG0003620	5	0	0	0	5
OG0003621	1	2	1	1	5
OG0003622	1	1	2	1	5
OG0003623	1	2	1	1	5
OG0003624	4	0	0	1	5
OG0003625	1	2	1	1	5
OG0003626	2	1	1	1	5
OG0003627	1	1	1	2	5
OG0003628	2	1	1	1	5
OG0003629	1	1	1	2	5
OG0003630	1	3	1	0	5
OG0003631	2	1	2	0	5
OG0003632	1	1	2	1	5
OG0003633	2	1	1	1	5
OG0003634	1	1	2	1	5
OG0003635	1	2	1	1	5
OG0003636	1	2	1	1	5
OG0003637	1	1	1	2	5
OG0003638	1	3	1	0	5
OG0003639	1	1	1	2	5
OG0003640	1	2	2	0	5
OG0003641	1	1	1	2	5
OG0003642	2	1	1	1	5
OG0003643	1	1	1	2	5
OG0003644	1	1	1	2	5
OG0003645	2	1	1	1	5
OG0003646	4	1	0	0	5
OG0003647	2	1	1	1	5
OG0003648	1	1	2	1	5
OG0003649	2	1	1	1	5
OG0003650	2	1	1	1	5
OG0003651	2	1	1	1	5
OG0003652	1	1	1	2	5
OG0003653	2	1	1	1	5
OG0003654	1	1	1	2	5
OG0003655	4	0	0	1	5
OG0003656	1	1	1	2	5
OG0003657	1	1	1	2	5
OG0003658	3	1	1	0	5
OG0003659	2	1	1	1	5
OG0003660	1	1	1	2	5
OG0003661	1	1	2	1	5
OG0003662	1	1	1	2	5
OG0003663	1	1	3	0	5
OG0003664	2	1	1	1	5
OG0003665	2	1	1	1	5
OG0003666	2	1	1	1	5
OG0003667	2	1	1	1	5
OG0003668	2	1	1	1	5
OG0003669	2	1	1	1	5
OG0003670	2	1	1	1	5
OG0003671	2	1	1	1	5
OG0003672	2	1	1	1	5
OG0003673	1	1	1	2	5
OG0003674	2	1	1	1	5
OG0003675	1	3	1	0	5
OG0003676	3	2	0	0	5
OG0003677	1	1	1	2	5
OG0003678	1	1	2	1	5
OG0003679	1	1	2	1	5
OG0003680	1	1	2	1	5
OG0003681	1	1	2	1	5
OG0003682	2	1	1	1	5
OG0003683	1	1	1	2	5
OG0003684	1	3	1	0	5
OG0003685	1	1	1	2	5
OG0003686	1	1	2	1	5
OG0003687	2	1	1	1	5
OG0003688	2	1	1	1	5
OG0003689	2	1	1	1	5
OG0003690	2	1	1	1	5
OG0003691	1	1	1	2	5
OG0003692	1	1	0	3	5
OG0003693	2	2	1	0	5
OG0003694	1	1	1	2	5
OG0003695	1	0	1	3	5
OG0003696	2	1	1	1	5
OG0003697	2	1	1	1	5
OG0003698	2	1	1	1	5
OG0003699	1	1	0	3	5
OG0003700	2	1	1	1	5
OG0003701	1	1	1	2	5
OG0003702	2	1	1	1	5
OG0003703	1	2	1	1	5
OG0003704	1	2	1	1	5
OG0003705	2	1	1	1	5
OG0003706	1	1	2	1	5
OG0003707	1	2	1	1	5
OG0003708	4	1	0	0	5
OG0003709	1	4	0	0	5
OG0003710	2	1	1	1	5
OG0003711	2	1	1	1	5
OG0003712	2	1	1	1	5
OG0003713	2	0	0	3	5
OG0003714	2	1	1	1	5
OG0003715	1	1	1	2	5
OG0003716	1	1	1	2	5
OG0003717	1	2	0	2	5
OG0003718	1	1	1	2	5
OG0003719	1	1	2	1	5
OG0003720	1	1	2	1	5
OG0003721	1	1	1	2	5
OG0003722	1	1	0	3	5
OG0003723	1	2	1	1	5
OG0003724	1	1	1	2	5
OG0003725	2	1	1	1	5
OG0003726	1	1	2	1	5
OG0003727	1	1	2	1	5
OG0003728	2	1	1	1	5
OG0003729	2	1	1	1	5
OG0003730	1	1	2	1	5
OG0003731	2	1	1	1	5
OG0003732	1	1	2	1	5
OG0003733	1	1	1	2	5
OG0003734	2	1	1	1	5
OG0003735	1	2	1	1	5
OG0003736	1	1	3	0	5
OG0003737	2	2	1	0	5
OG0003738	2	1	1	1	5
OG0003739	2	1	1	1	5
OG0003740	1	1	1	2	5
OG0003741	1	1	2	1	5
OG0003742	1	2	1	1	5
OG0003743	1	2	1	1	5
OG0003744	1	1	1	2	5
OG0003745	2	1	1	1	5
OG0003746	2	0	3	0	5
OG0003747	4	1	0	0	5
OG0003748	2	2	1	0	5
OG0003749	1	1	1	2	5
OG0003750	2	1	1	1	5
OG0003751	1	2	2	0	5
OG0003752	1	1	2	1	5
OG0003753	2	1	1	1	5
OG0003754	1	2	1	1	5
OG0003755	1	1	1	2	5
OG0003756	2	1	1	1	5
OG0003757	2	0	0	3	5
OG0003758	5	0	0	0	5
OG0003759	1	1	2	1	5
OG0003760	1	1	1	2	5
OG0003761	1	2	1	1	5
OG0003762	2	1	1	1	5
OG0003763	2	1	1	1	5
OG0003764	5	0	0	0	5
OG0003765	2	1	1	1	5
OG0003766	2	1	2	0	5
OG0003767	2	1	1	1	5
OG0003768	1	1	2	1	5
OG0003769	5	0	0	0	5
OG0003770	1	1	1	2	5
OG0003771	1	1	1	2	5
OG0003772	1	1	1	2	5
OG0003773	2	1	1	1	5
OG0003774	1	1	2	1	5
OG0003775	1	1	2	1	5
OG0003776	4	1	0	0	5
OG0003777	1	1	1	2	5
OG0003778	2	1	1	1	5
OG0003779	1	2	1	1	5
OG0003780	1	2	1	1	5
OG0003781	1	1	1	2	5
OG0003782	2	1	1	1	5
OG0003783	2	1	1	1	5
OG0003784	1	2	2	0	5
OG0003785	1	3	1	0	5
OG0003786	4	0	1	0	5
OG0003787	2	1	1	1	5
OG0003788	2	3	0	0	5
OG0003789	2	1	1	1	5
OG0003790	4	0	1	0	5
OG0003791	1	1	2	1	5
OG0003792	1	1	2	1	5
OG0003793	1	1	1	2	5
OG0003794	2	1	1	1	5
OG0003795	2	0	1	2	5
OG0003796	1	1	1	2	5
OG0003797	2	1	1	1	5
OG0003798	1	2	2	0	5
OG0003799	2	2	1	0	5
OG0003800	1	1	2	1	5
OG0003801	2	1	1	1	5
OG0003802	2	1	1	1	5
OG0003803	1	1	1	2	5
OG0003804	2	1	1	1	5
OG0003805	2	1	1	1	5
OG0003806	1	1	1	2	5
OG0003807	2	1	1	1	5
OG0003808	1	2	1	1	5
OG0003809	2	2	1	0	5
OG0003810	1	1	1	2	5
OG0003811	1	1	2	1	5
OG0003812	2	1	1	1	5
OG0003813	1	1	1	2	5
OG0003814	1	1	1	2	5
OG0003815	1	2	2	0	5
OG0003816	1	1	1	2	5
OG0003817	1	1	3	0	5
OG0003818	1	1	2	1	5
OG0003819	1	1	2	1	5
OG0003820	1	1	1	2	5
OG0003821	1	1	2	1	5
OG0003822	1	1	2	1	5
OG0003823	2	1	1	1	5
OG0003824	2	1	1	1	5
OG0003825	2	1	1	1	5
OG0003826	1	1	3	0	5
OG0003827	1	3	1	0	5
OG0003828	1	2	1	1	5
OG0003829	2	1	1	1	5
OG0003830	1	2	1	1	5
OG0003831	1	1	2	1	5
OG0003832	1	1	1	2	5
OG0003833	2	1	1	1	5
OG0003834	2	1	1	1	5
OG0003835	2	1	1	1	5
OG0003836	2	1	1	1	5
OG0003837	2	1	1	1	5
OG0003838	1	1	2	1	5
OG0003839	2	1	1	1	5
OG0003840	5	0	0	0	5
OG0003841	1	2	1	1	5
OG0003842	1	1	1	2	5
OG0003843	2	1	1	1	5
OG0003844	4	0	1	0	5
OG0003845	1	1	1	2	5
OG0003846	1	0	3	1	5
OG0003847	1	1	1	2	5
OG0003848	1	1	2	1	5
OG0003849	1	2	1	1	5
OG0003850	1	1	2	1	5
OG0003851	2	1	2	0	5
OG0003852	2	1	2	0	5
OG0003853	1	2	1	1	5
OG0003854	1	1	3	0	5
OG0003855	1	1	1	2	5
OG0003856	2	1	1	1	5
OG0003857	1	1	1	2	5
OG0003858	1	1	1	2	5
OG0003859	2	1	1	1	5
OG0003860	2	1	1	1	5
OG0003861	5	0	0	0	5
OG0003862	1	1	1	2	5
OG0003863	2	1	1	1	5
OG0003864	2	1	1	1	5
OG0003865	2	2	1	0	5
OG0003866	2	1	1	1	5
OG0003867	2	1	2	0	5
OG0003868	1	1	1	2	5
OG0003869	1	1	1	2	5
OG0003870	1	1	3	0	5
OG0003871	1	1	1	2	5
OG0003872	1	1	2	1	5
OG0003873	1	2	1	1	5
OG0003874	1	1	1	2	5
OG0003875	1	1	2	1	5
OG0003876	2	1	1	1	5
OG0003877	1	1	2	1	5
OG0003878	2	1	1	1	5
OG0003879	1	1	2	1	5
OG0003880	1	1	1	2	5
OG0003881	1	1	2	1	5
OG0003882	1	1	1	2	5
OG0003883	2	1	1	1	5
OG0003884	1	1	1	2	5
OG0003885	2	1	2	0	5
OG0003886	2	1	1	1	5
OG0003887	1	1	1	2	5
OG0003888	1	1	2	1	5
OG0003889	2	1	1	1	5
OG0003890	2	1	1	1	5
OG0003891	2	1	1	1	5
OG0003892	2	1	1	1	5
OG0003893	2	1	1	1	5
OG0003894	1	1	1	2	5
OG0003895	2	2	1	0	5
OG0003896	2	1	1	1	5
OG0003897	1	2	1	1	5
OG0003898	2	1	1	1	5
OG0003899	2	1	1	1	5
OG0003900	1	1	2	1	5
OG0003901	2	1	1	1	5
OG0003902	1	1	2	1	5
OG0003903	1	1	1	2	5
OG0003904	1	1	2	1	5
OG0003905	1	2	1	1	5
OG0003906	2	2	0	1	5
OG0003907	1	1	3	0	5
OG0003908	1	1	2	1	5
OG0003909	2	1	1	1	5
OG0003910	2	1	1	1	5
OG0003911	1	1	2	1	5
OG0003912	3	1	1	0	5
OG0003913	2	1	1	1	5
OG0003914	1	1	1	2	5
OG0003915	2	1	1	1	5
OG0003916	1	1	1	2	5
OG0003917	1	1	1	2	5
OG0003918	1	1	1	2	5
OG0003919	3	1	0	1	5
OG0003920	2	1	1	1	5
OG0003921	2	1	1	1	5
OG0003922	1	2	1	1	5
OG0003923	2	1	1	1	5
OG0003924	1	1	2	1	5
OG0003925	2	1	1	1	5
OG0003926	2	1	1	1	5
OG0003927	1	1	2	1	5
OG0003928	1	1	1	2	5
OG0003929	2	1	1	1	5
OG0003930	2	1	1	1	5
OG0003931	1	1	1	2	5
OG0003932	2	1	1	1	5
OG0003933	2	1	1	1	5
OG0003934	3	1	1	0	5
OG0003935	2	1	1	1	5
OG0003936	1	1	1	2	5
OG0003937	1	1	2	1	5
OG0003938	2	1	2	0	5
OG0003939	2	1	1	1	5
OG0003940	1	1	1	2	5
OG0003941	1	1	2	1	5
OG0003942	4	1	0	0	5
OG0003943	2	1	1	1	5
OG0003944	1	4	0	0	5
OG0003945	1	1	1	2	5
OG0003946	3	1	1	0	5
OG0003947	1	1	1	2	5
OG0003948	2	1	1	1	5
OG0003949	1	1	2	1	5
OG0003950	1	1	1	2	5
OG0003951	1	1	1	2	5
OG0003952	1	1	2	1	5
OG0003953	1	2	2	0	5
OG0003954	5	0	0	0	5
OG0003955	2	1	1	1	5
OG0003956	1	1	2	1	5
OG0003957	1	1	1	2	5
OG0003958	2	1	1	1	5
OG0003959	2	1	1	1	5
OG0003960	1	1	1	2	5
OG0003961	2	1	1	1	5
OG0003962	2	1	1	1	5
OG0003963	1	0	3	1	5
OG0003964	2	1	1	1	5
OG0003965	1	1	2	1	5
OG0003966	1	1	1	2	5
OG0003967	1	2	1	1	5
OG0003968	1	1	2	1	5
OG0003969	1	1	2	1	5
OG0003970	1	1	1	2	5
OG0003971	1	0	2	2	5
OG0003972	1	1	1	2	5
OG0003973	1	1	2	1	5
OG0003974	2	1	1	1	5
OG0003975	1	1	1	2	5
OG0003976	1	1	2	1	5
OG0003977	1	1	1	2	5
OG0003978	1	1	1	2	5
OG0003979	1	1	2	1	5
OG0003980	1	1	2	1	5
OG0003981	2	1	1	1	5
OG0003982	2	1	1	1	5
OG0003983	1	1	1	2	5
OG0003984	1	1	2	1	5
OG0003985	1	1	1	2	5
OG0003986	1	1	1	2	5
OG0003987	1	1	1	2	5
OG0003988	1	1	1	2	5
OG0003989	1	1	1	2	5
OG0003990	1	1	1	2	5
OG0003991	2	2	1	0	5
OG0003992	1	2	2	0	5
OG0003993	2	1	1	1	5
OG0003994	1	1	1	2	5
OG0003995	1	1	2	1	5
OG0003996	1	1	1	2	5
OG0003997	1	1	1	2	5
OG0003998	1	1	1	2	5
OG0003999	1	1	1	2	5
OG0004000	2	1	1	1	5
OG0004001	1	1	1	2	5
OG0004002	1	1	2	1	5
OG0004003	2	1	1	1	5
OG0004004	2	1	1	1	5
OG0004005	1	1	2	1	5
OG0004006	2	1	1	1	5
OG0004007	1	1	2	1	5
OG0004008	2	0	3	0	5
OG0004009	1	1	1	2	5
OG0004010	1	1	2	1	5
OG0004011	1	0	3	1	5
OG0004012	1	1	3	0	5
OG0004013	1	2	1	1	5
OG0004014	2	1	1	1	5
OG0004015	1	1	3	0	5
OG0004016	1	1	1	2	5
OG0004017	1	0	0	4	5
OG0004018	2	1	1	1	5
OG0004019	1	1	1	2	5
OG0004020	2	1	1	1	5
OG0004021	2	1	1	1	5
OG0004022	1	1	1	2	5
OG0004023	1	1	1	2	5
OG0004024	1	2	1	1	5
OG0004025	2	3	0	0	5
OG0004026	1	1	1	2	5
OG0004027	1	1	2	1	5
OG0004028	1	1	1	2	5
OG0004029	2	2	1	0	5
OG0004030	1	1	2	1	5
OG0004031	2	1	1	1	5
OG0004032	1	3	1	0	5
OG0004033	1	2	1	1	5
OG0004034	2	1	1	1	5
OG0004035	1	1	1	2	5
OG0004036	4	0	1	0	5
OG0004037	2	1	1	1	5
OG0004038	1	1	2	1	5
OG0004039	2	1	1	1	5
OG0004040	1	1	1	2	5
OG0004041	1	2	1	1	5
OG0004042	2	1	1	1	5
OG0004043	1	1	1	2	5
OG0004044	1	4	0	0	5
OG0004045	1	1	2	1	5
OG0004046	2	1	1	1	5
OG0004047	1	1	2	1	5
OG0004048	1	0	2	2	5
OG0004049	2	1	1	1	5
OG0004050	3	1	1	0	5
OG0004051	1	1	2	1	5
OG0004052	1	1	1	2	5
OG0004053	1	2	2	0	5
OG0004054	1	1	2	1	5
OG0004055	1	1	1	2	5
OG0004056	1	2	1	1	5
OG0004057	1	1	3	0	5
OG0004058	1	1	1	2	5
OG0004059	1	1	1	2	5
OG0004060	2	1	2	0	5
OG0004061	4	0	1	0	5
OG0004062	1	1	2	1	5
OG0004063	2	1	1	1	5
OG0004064	3	1	0	1	5
OG0004065	1	1	1	2	5
OG0004066	1	2	1	1	5
OG0004067	2	0	0	3	5
OG0004068	2	1	1	1	5
OG0004069	2	1	1	1	5
OG0004070	1	0	0	4	5
OG0004071	2	1	1	1	5
OG0004072	1	1	1	2	5
OG0004073	1	1	1	2	5
OG0004074	1	1	1	2	5
OG0004075	1	1	1	2	5
OG0004076	5	0	0	0	5
OG0004077	1	2	1	1	5
OG0004078	1	1	1	2	5
OG0004079	1	2	1	1	5
OG0004080	2	1	1	1	5
OG0004081	1	1	1	2	5
OG0004082	1	1	1	2	5
OG0004083	2	1	1	1	5
OG0004084	1	3	1	0	5
OG0004085	1	1	2	1	5
OG0004086	5	0	0	0	5
OG0004087	1	2	2	0	5
OG0004088	1	3	1	0	5
OG0004089	1	1	1	2	5
OG0004090	1	1	2	1	5
OG0004091	1	1	2	1	5
OG0004092	2	1	1	1	5
OG0004093	1	1	1	2	5
OG0004094	1	1	1	2	5
OG0004095	1	2	1	1	5
OG0004096	1	0	3	1	5
OG0004097	1	2	2	0	5
OG0004098	1	1	2	1	5
OG0004099	1	3	0	1	5
OG0004100	1	0	1	3	5
OG0004101	2	1	1	1	5
OG0004102	1	2	1	1	5
OG0004103	2	1	1	1	5
OG0004104	1	3	1	0	5
OG0004105	2	1	1	1	5
OG0004106	1	1	1	2	5
OG0004107	1	2	2	0	5
OG0004108	2	1	1	1	5
OG0004109	1	1	1	2	5
OG0004110	1	1	1	2	5
OG0004111	1	2	1	1	5
OG0004112	2	1	2	0	5
OG0004113	2	1	1	1	5
OG0004114	2	1	2	0	5
OG0004115	1	1	2	1	5
OG0004116	1	1	2	1	5
OG0004117	1	2	2	0	5
OG0004118	1	1	2	1	5
OG0004119	2	1	2	0	5
OG0004120	2	1	1	1	5
OG0004121	1	1	1	2	5
OG0004122	1	1	2	1	5
OG0004123	1	2	1	1	5
OG0004124	1	3	1	0	5
OG0004125	1	1	2	1	5
OG0004126	1	1	3	0	5
OG0004127	1	1	1	2	5
OG0004128	1	3	1	0	5
OG0004129	1	1	1	2	5
OG0004130	1	2	2	0	5
OG0004131	1	1	2	1	5
OG0004132	1	4	0	0	5
OG0004133	1	1	2	1	5
OG0004134	5	0	0	0	5
OG0004135	1	1	2	1	5
OG0004136	2	1	1	1	5
OG0004137	1	1	1	2	5
OG0004138	1	1	2	1	5
OG0004139	2	1	1	1	5
OG0004140	1	1	1	2	5
OG0004141	1	0	0	4	5
OG0004142	1	1	1	2	5
OG0004143	5	0	0	0	5
OG0004144	2	1	1	1	5
OG0004145	1	1	2	1	5
OG0004146	1	0	3	1	5
OG0004147	2	1	1	1	5
OG0004148	1	1	2	1	5
OG0004149	1	1	1	2	5
OG0004150	1	1	1	2	5
OG0004151	1	1	1	2	5
OG0004152	1	2	1	1	5
OG0004153	1	0	3	1	5
OG0004154	1	0	4	0	5
OG0004155	1	2	1	1	5
OG0004156	1	1	2	1	5
OG0004157	1	4	0	0	5
OG0004158	2	1	1	1	5
OG0004159	1	1	1	2	5
OG0004160	1	3	1	0	5
OG0004161	1	1	2	1	5
OG0004162	2	1	2	0	5
OG0004163	1	3	1	0	5
OG0004164	1	1	1	2	5
OG0004165	1	2	1	1	5
OG0004166	1	2	1	1	5
OG0004167	1	1	1	2	5
OG0004168	2	1	1	1	5
OG0004169	1	1	1	2	5
OG0004170	1	2	1	1	5
OG0004171	1	1	2	1	5
OG0004172	2	1	1	1	5
OG0004173	1	1	1	2	5
OG0004174	2	1	1	1	5
OG0004175	1	3	1	0	5
OG0004176	1	1	3	0	5
OG0004177	1	1	1	2	5
OG0004178	0	5	0	0	5
OG0004179	0	4	1	0	5
OG0004180	0	5	0	0	5
OG0004181	0	5	0	0	5
OG0004182	0	2	2	1	5
OG0004183	0	5	0	0	5
OG0004184	0	5	0	0	5
OG0004185	0	4	0	1	5
OG0004186	0	5	0	0	5
OG0004187	0	5	0	0	5
OG0004188	0	5	0	0	5
OG0004189	0	1	2	2	5
OG0004190	0	2	3	0	5
OG0004191	0	2	0	3	5
OG0004192	0	1	3	1	5
OG0004193	0	5	0	0	5
OG0004194	0	1	2	2	5
OG0004195	0	5	0	0	5
OG0004196	0	1	2	2	5
OG0004197	0	2	2	1	5
OG0004198	0	5	0	0	5
OG0004199	0	5	0	0	5
OG0004200	0	5	0	0	5
OG0004201	0	4	0	1	5
OG0004202	0	5	0	0	5
OG0004203	0	5	0	0	5
OG0004204	0	5	0	0	5
OG0004205	0	5	0	0	5
OG0004206	0	4	0	1	5
OG0004207	0	1	1	3	5
OG0004208	0	5	0	0	5
OG0004209	0	3	1	1	5
OG0004210	0	5	0	0	5
OG0004211	0	4	1	0	5
OG0004212	0	5	0	0	5
OG0004213	0	4	1	0	5
OG0004214	0	5	0	0	5
OG0004215	0	1	4	0	5
OG0004216	0	5	0	0	5
OG0004217	0	5	0	0	5
OG0004218	0	2	1	2	5
OG0004219	0	5	0	0	5
OG0004220	0	2	3	0	5
OG0004221	0	5	0	0	5
OG0004222	0	3	2	0	5
OG0004223	0	1	4	0	5
OG0004224	0	5	0	0	5
OG0004225	0	4	1	0	5
OG0004226	0	4	1	0	5
OG0004227	0	2	3	0	5
OG0004228	0	1	1	3	5
OG0004229	0	4	1	0	5
OG0004230	0	5	0	0	5
OG0004231	0	1	0	4	5
OG0004232	0	2	2	1	5
OG0004233	0	1	1	3	5
OG0004234	0	2	3	0	5
OG0004235	0	1	2	2	5
OG0004236	0	5	0	0	5
OG0004237	0	0	5	0	5
OG0004238	0	0	5	0	5
OG0004239	0	0	5	0	5
OG0004240	0	0	5	0	5
OG0004241	0	0	5	0	5
OG0004242	0	0	5	0	5
OG0004243	0	0	5	0	5
OG0004244	0	0	5	0	5
OG0004245	0	0	5	0	5
OG0004246	0	0	5	0	5
OG0004247	0	0	5	0	5
OG0004248	0	0	5	0	5
OG0004249	0	0	5	0	5
OG0004250	0	0	5	0	5
OG0004251	0	0	5	0	5
OG0004252	0	0	5	0	5
OG0004253	0	0	5	0	5
OG0004254	0	0	5	0	5
OG0004255	0	0	5	0	5
OG0004256	0	0	5	0	5
OG0004257	0	0	5	0	5
OG0004258	0	0	5	0	5
OG0004259	0	0	1	4	5
OG0004260	0	0	5	0	5
OG0004261	0	0	5	0	5
OG0004262	0	0	2	3	5
OG0004263	0	0	5	0	5
OG0004264	0	0	3	2	5
OG0004265	0	0	5	0	5
OG0004266	0	0	5	0	5
OG0004267	0	0	5	0	5
OG0004268	0	0	5	0	5
OG0004269	0	0	5	0	5
OG0004270	0	0	5	0	5
OG0004271	0	0	5	0	5
OG0004272	0	0	5	0	5
OG0004273	0	0	5	0	5
OG0004274	0	0	5	0	5
OG0004275	0	0	5	0	5
OG0004276	0	0	5	0	5
OG0004277	0	0	5	0	5
OG0004278	0	0	5	0	5
OG0004279	0	0	5	0	5
OG0004280	0	0	5	0	5
OG0004281	0	0	5	0	5
OG0004282	0	0	5	0	5
OG0004283	0	0	5	0	5
OG0004284	0	0	5	0	5
OG0004285	0	0	5	0	5
OG0004286	0	0	5	0	5
OG0004287	0	0	5	0	5
OG0004288	0	0	5	0	5
OG0004289	0	0	5	0	5
OG0004290	0	0	5	0	5
OG0004291	0	0	2	3	5
OG0004292	0	0	5	0	5
OG0004293	0	0	1	4	5
OG0004294	0	0	5	0	5
OG0004295	0	0	5	0	5
OG0004296	0	0	5	0	5
OG0004297	0	0	2	3	5
OG0004298	0	0	5	0	5
OG0004299	0	0	1	4	5
OG0004300	0	0	5	0	5
OG0004301	0	0	5	0	5
OG0004302	0	0	5	0	5
OG0004303	0	0	5	0	5
OG0004304	0	0	1	4	5
OG0004305	0	0	5	0	5
OG0004306	0	0	5	0	5
OG0004307	0	0	5	0	5
OG0004308	0	0	1	4	5
OG0004309	0	0	2	3	5
OG0004310	0	0	5	0	5
OG0004311	0	0	5	0	5
OG0004312	0	0	5	0	5
OG0004313	0	0	5	0	5
OG0004314	0	0	5	0	5
OG0004315	0	0	5	0	5
OG0004316	0	0	5	0	5
OG0004317	0	0	5	0	5
OG0004318	0	0	5	0	5
OG0004319	0	0	5	0	5
OG0004320	0	0	3	2	5
OG0004321	0	0	1	4	5
OG0004322	0	0	5	0	5
OG0004323	0	0	5	0	5
OG0004324	0	0	1	4	5
OG0004325	0	0	0	5	5
OG0004326	0	0	0	5	5
OG0004327	0	0	0	5	5
OG0004328	0	0	0	5	5
OG0004329	0	0	0	5	5
OG0004330	0	0	0	5	5
OG0004331	0	0	0	5	5
OG0004332	0	0	0	5	5
OG0004333	0	0	0	5	5
OG0004334	0	0	0	5	5
OG0004335	0	0	0	5	5
OG0004336	0	0	0	5	5
OG0004337	0	0	0	5	5
OG0004338	0	0	0	5	5
OG0004339	0	0	0	5	5
OG0004340	0	0	0	5	5
OG0004341	0	0	0	5	5
OG0004342	0	0	0	5	5
OG0004343	0	0	0	5	5
OG0004344	0	0	0	5	5
OG0004345	0	0	0	5	5
OG0004346	0	0	0	5	5
OG0004347	0	0	0	5	5
OG0004348	0	0	0	5	5
OG0004349	0	0	0	5	5
OG0004350	0	0	0	5	5
OG0004351	0	0	0	5	5
OG0004352	0	0	0	5	5
OG0004353	0	0	0	5	5
OG0004354	0	0	0	5	5
OG0004355	0	0	0	5	5
OG0004356	0	0	0	5	5
OG0004357	0	0	0	5	5
OG0004358	0	0	0	5	5
OG0004359	0	0	0	5	5
OG0004360	0	0	0	5	5
OG0004361	0	0	0	5	5
OG0004362	0	0	0	5	5
OG0004363	0	0	0	5	5
OG0004364	0	0	0	5	5
OG0004365	0	0	0	5	5
OG0004366	0	0	0	5	5
OG0004367	0	0	0	5	5
OG0004368	0	0	0	5	5
OG0004369	0	0	0	5	5
OG0004370	0	0	0	5	5
OG0004371	0	0	0	5	5
OG0004372	0	0	0	5	5
OG0004373	0	0	0	5	5
OG0004374	0	0	0	5	5
OG0004375	0	0	0	5	5
OG0004376	0	0	0	5	5
OG0004377	0	0	0	5	5
OG0004378	0	0	0	5	5
OG0004379	0	0	0	5	5
OG0004380	0	0	0	5	5
OG0004381	0	0	0	5	5
OG0004382	0	0	0	5	5
OG0004383	0	0	0	5	5
OG0004384	0	0	0	5	5
OG0004385	0	0	0	5	5
OG0004386	0	0	0	5	5
OG0004387	0	0	0	5	5
OG0004388	0	0	0	5	5
OG0004389	0	0	0	5	5
OG0004390	0	0	0	5	5
OG0004391	0	0	0	5	5
OG0004392	0	0	0	5	5
OG0004393	0	0	0	5	5
OG0004394	0	0	0	5	5
OG0004395	0	0	0	5	5
OG0004396	0	0	0	5	5
OG0004397	0	0	0	5	5
OG0004398	0	0	0	5	5
OG0004399	0	0	0	5	5
OG0004400	0	0	0	5	5
OG0004401	0	0	0	5	5
OG0004402	0	0	0	5	5
OG0004403	0	0	0	5	5
OG0004404	0	0	0	5	5
OG0004405	0	0	0	5	5
OG0004406	0	0	0	5	5
OG0004407	0	0	0	5	5
OG0004408	0	0	0	5	5
OG0004409	0	0	0	5	5
OG0004410	0	0	0	5	5
OG0004411	0	0	0	5	5
OG0004412	0	0	0	5	5
OG0004413	0	0	0	5	5
OG0004414	0	0	0	5	5
OG0004415	0	0	0	5	5
OG0004416	0	0	0	5	5
OG0004417	0	0	0	5	5
OG0004418	0	0	0	5	5
OG0004419	0	0	0	5	5
OG0004420	0	0	0	5	5
OG0004421	0	0	0	5	5
OG0004422	0	0	0	5	5
OG0004423	0	0	0	5	5
OG0004424	0	0	0	5	5
OG0004425	0	0	0	5	5
OG0004426	0	0	0	5	5
OG0004427	0	0	0	5	5
OG0004428	0	0	0	5	5
OG0004429	0	0	0	5	5
OG0004430	0	0	0	5	5
OG0004431	0	0	0	5	5
OG0004432	0	0	0	5	5
OG0004433	0	0	0	5	5
OG0004434	0	0	0	5	5
OG0004435	0	0	0	5	5
OG0004436	0	0	0	5	5
OG0004437	0	0	0	5	5
OG0004438	0	0	0	5	5
OG0004439	1	1	1	1	4
OG0004440	4	0	0	0	4
OG0004441	1	1	1	1	4
OG0004442	1	1	1	1	4
OG0004443	1	1	1	1	4
OG0004444	1	1	1	1	4
OG0004445	1	1	1	1	4
OG0004446	2	1	1	0	4
OG0004447	1	1	1	1	4
OG0004448	1	1	1	1	4
OG0004449	1	1	1	1	4
OG0004450	2	1	1	0	4
OG0004451	1	1	1	1	4
OG0004452	1	1	1	1	4
OG0004453	1	1	1	1	4
OG0004454	1	1	1	1	4
OG0004455	2	1	1	0	4
OG0004456	1	1	1	1	4
OG0004457	1	1	1	1	4
OG0004458	1	1	1	1	4
OG0004459	1	1	1	1	4
OG0004460	1	1	1	1	4
OG0004461	1	1	1	1	4
OG0004462	1	1	1	1	4
OG0004463	1	1	1	1	4
OG0004464	1	1	1	1	4
OG0004465	1	1	1	1	4
OG0004466	1	1	1	1	4
OG0004467	1	1	1	1	4
OG0004468	1	1	1	1	4
OG0004469	1	1	1	1	4
OG0004470	1	1	1	1	4
OG0004471	1	1	1	1	4
OG0004472	1	1	1	1	4
OG0004473	1	1	1	1	4
OG0004474	1	1	1	1	4
OG0004475	1	1	1	1	4
OG0004476	1	1	1	1	4
OG0004477	1	1	1	1	4
OG0004478	1	1	1	1	4
OG0004479	1	1	1	1	4
OG0004480	1	1	1	1	4
OG0004481	1	1	1	1	4
OG0004482	1	1	1	1	4
OG0004483	1	1	1	1	4
OG0004484	1	1	1	1	4
OG0004485	1	1	1	1	4
OG0004486	1	1	1	1	4
OG0004487	1	1	2	0	4
OG0004488	1	2	1	0	4
OG0004489	1	1	1	1	4
OG0004490	1	1	1	1	4
OG0004491	1	1	1	1	4
OG0004492	1	1	2	0	4
OG0004493	1	1	1	1	4
OG0004494	1	1	1	1	4
OG0004495	1	1	1	1	4
OG0004496	1	1	1	1	4
OG0004497	2	1	1	0	4
OG0004498	1	1	1	1	4
OG0004499	1	1	1	1	4
OG0004500	2	1	1	0	4
OG0004501	1	1	1	1	4
OG0004502	1	1	1	1	4
OG0004503	2	2	0	0	4
OG0004504	1	1	1	1	4
OG0004505	2	1	1	0	4
OG0004506	1	1	1	1	4
OG0004507	1	1	1	1	4
OG0004508	1	1	1	1	4
OG0004509	1	1	1	1	4
OG0004510	1	1	1	1	4
OG0004511	4	0	0	0	4
OG0004512	1	1	1	1	4
OG0004513	1	1	1	1	4
OG0004514	1	1	1	1	4
OG0004515	1	1	1	1	4
OG0004516	1	1	1	1	4
OG0004517	1	1	1	1	4
OG0004518	1	1	1	1	4
OG0004519	2	1	1	0	4
OG0004520	1	1	1	1	4
OG0004521	1	1	1	1	4
OG0004522	1	1	1	1	4
OG0004523	1	1	1	1	4
OG0004524	1	1	1	1	4
OG0004525	4	0	0	0	4
OG0004526	1	1	1	1	4
OG0004527	1	1	1	1	4
OG0004528	1	1	1	1	4
OG0004529	1	1	1	1	4
OG0004530	1	1	1	1	4
OG0004531	1	1	1	1	4
OG0004532	1	1	1	1	4
OG0004533	2	1	1	0	4
OG0004534	2	1	1	0	4
OG0004535	1	1	1	1	4
OG0004536	1	1	1	1	4
OG0004537	1	1	1	1	4
OG0004538	1	1	1	1	4
OG0004539	1	1	1	1	4
OG0004540	1	1	1	1	4
OG0004541	1	1	1	1	4
OG0004542	1	1	1	1	4
OG0004543	1	1	1	1	4
OG0004544	1	1	1	1	4
OG0004545	1	1	1	1	4
OG0004546	1	1	1	1	4
OG0004547	1	1	1	1	4
OG0004548	1	1	1	1	4
OG0004549	1	1	1	1	4
OG0004550	1	1	1	1	4
OG0004551	1	1	1	1	4
OG0004552	1	1	1	1	4
OG0004553	1	1	1	1	4
OG0004554	1	1	1	1	4
OG0004555	1	1	1	1	4
OG0004556	1	1	2	0	4
OG0004557	1	1	1	1	4
OG0004558	1	1	1	1	4
OG0004559	4	0	0	0	4
OG0004560	2	0	1	1	4
OG0004561	1	1	1	1	4
OG0004562	1	1	1	1	4
OG0004563	1	1	1	1	4
OG0004564	1	1	1	1	4
OG0004565	1	1	1	1	4
OG0004566	1	1	1	1	4
OG0004567	1	1	1	1	4
OG0004568	1	1	1	1	4
OG0004569	2	1	1	0	4
OG0004570	1	1	1	1	4
OG0004571	1	1	1	1	4
OG0004572	1	1	1	1	4
OG0004573	1	1	1	1	4
OG0004574	1	1	1	1	4
OG0004575	1	1	1	1	4
OG0004576	1	1	1	1	4
OG0004577	1	1	1	1	4
OG0004578	1	1	1	1	4
OG0004579	1	1	1	1	4
OG0004580	1	1	1	1	4
OG0004581	1	1	1	1	4
OG0004582	1	1	1	1	4
OG0004583	1	1	1	1	4
OG0004584	1	1	1	1	4
OG0004585	4	0	0	0	4
OG0004586	1	1	1	1	4
OG0004587	1	1	1	1	4
OG0004588	1	1	1	1	4
OG0004589	1	1	1	1	4
OG0004590	1	1	1	1	4
OG0004591	1	1	1	1	4
OG0004592	1	1	1	1	4
OG0004593	1	1	1	1	4
OG0004594	1	1	1	1	4
OG0004595	1	1	1	1	4
OG0004596	1	1	1	1	4
OG0004597	1	1	1	1	4
OG0004598	1	1	1	1	4
OG0004599	1	1	1	1	4
OG0004600	1	1	1	1	4
OG0004601	2	1	1	0	4
OG0004602	1	1	1	1	4
OG0004603	1	1	1	1	4
OG0004604	1	1	1	1	4
OG0004605	1	1	1	1	4
OG0004606	1	1	1	1	4
OG0004607	4	0	0	0	4
OG0004608	1	1	1	1	4
OG0004609	1	1	1	1	4
OG0004610	1	1	1	1	4
OG0004611	1	1	1	1	4
OG0004612	3	1	0	0	4
OG0004613	1	1	1	1	4
OG0004614	1	1	1	1	4
OG0004615	1	1	1	1	4
OG0004616	2	1	1	0	4
OG0004617	3	1	0	0	4
OG0004618	1	1	1	1	4
OG0004619	1	1	1	1	4
OG0004620	1	1	1	1	4
OG0004621	1	1	1	1	4
OG0004622	1	1	1	1	4
OG0004623	1	1	1	1	4
OG0004624	1	1	2	0	4
OG0004625	1	1	1	1	4
OG0004626	1	1	1	1	4
OG0004627	1	1	1	1	4
OG0004628	1	1	1	1	4
OG0004629	1	1	1	1	4
OG0004630	1	1	1	1	4
OG0004631	1	1	1	1	4
OG0004632	1	1	1	1	4
OG0004633	1	1	1	1	4
OG0004634	1	1	1	1	4
OG0004635	1	1	1	1	4
OG0004636	1	1	1	1	4
OG0004637	1	1	1	1	4
OG0004638	1	1	1	1	4
OG0004639	1	1	1	1	4
OG0004640	1	1	1	1	4
OG0004641	1	1	1	1	4
OG0004642	4	0	0	0	4
OG0004643	1	1	1	1	4
OG0004644	1	1	2	0	4
OG0004645	1	1	1	1	4
OG0004646	1	1	1	1	4
OG0004647	1	1	1	1	4
OG0004648	1	1	1	1	4
OG0004649	1	1	1	1	4
OG0004650	1	1	1	1	4
OG0004651	1	1	1	1	4
OG0004652	1	1	1	1	4
OG0004653	1	1	1	1	4
OG0004654	1	1	1	1	4
OG0004655	1	1	1	1	4
OG0004656	1	1	1	1	4
OG0004657	1	1	1	1	4
OG0004658	2	1	1	0	4
OG0004659	1	1	1	1	4
OG0004660	1	1	1	1	4
OG0004661	1	1	1	1	4
OG0004662	1	1	1	1	4
OG0004663	1	1	1	1	4
OG0004664	1	1	1	1	4
OG0004665	1	1	1	1	4
OG0004666	1	1	1	1	4
OG0004667	1	1	1	1	4
OG0004668	1	1	1	1	4
OG0004669	1	1	1	1	4
OG0004670	1	1	1	1	4
OG0004671	1	1	1	1	4
OG0004672	1	1	1	1	4
OG0004673	1	1	1	1	4
OG0004674	1	1	2	0	4
OG0004675	1	1	1	1	4
OG0004676	1	1	1	1	4
OG0004677	1	1	1	1	4
OG0004678	1	1	2	0	4
OG0004679	1	1	1	1	4
OG0004680	1	1	1	1	4
OG0004681	1	1	1	1	4
OG0004682	1	1	1	1	4
OG0004683	1	2	1	0	4
OG0004684	1	1	1	1	4
OG0004685	1	1	1	1	4
OG0004686	1	1	1	1	4
OG0004687	1	1	1	1	4
OG0004688	1	1	1	1	4
OG0004689	1	1	1	1	4
OG0004690	1	1	1	1	4
OG0004691	1	1	1	1	4
OG0004692	1	1	1	1	4
OG0004693	1	1	1	1	4
OG0004694	1	1	1	1	4
OG0004695	1	1	1	1	4
OG0004696	1	1	1	1	4
OG0004697	1	1	1	1	4
OG0004698	1	1	1	1	4
OG0004699	1	1	1	1	4
OG0004700	1	1	1	1	4
OG0004701	1	1	1	1	4
OG0004702	1	1	1	1	4
OG0004703	1	1	1	1	4
OG0004704	1	1	1	1	4
OG0004705	1	1	2	0	4
OG0004706	1	1	0	2	4
OG0004707	1	1	1	1	4
OG0004708	1	1	1	1	4
OG0004709	1	1	1	1	4
OG0004710	1	1	1	1	4
OG0004711	1	1	1	1	4
OG0004712	1	1	1	1	4
OG0004713	1	1	1	1	4
OG0004714	2	1	1	0	4
OG0004715	1	1	1	1	4
OG0004716	1	1	1	1	4
OG0004717	1	1	1	1	4
OG0004718	1	1	1	1	4
OG0004719	1	1	1	1	4
OG0004720	1	1	1	1	4
OG0004721	1	1	1	1	4
OG0004722	1	1	1	1	4
OG0004723	1	1	1	1	4
OG0004724	1	1	1	1	4
OG0004725	1	1	1	1	4
OG0004726	1	1	1	1	4
OG0004727	1	1	1	1	4
OG0004728	1	1	1	1	4
OG0004729	1	1	1	1	4
OG0004730	1	1	1	1	4
OG0004731	1	1	1	1	4
OG0004732	1	1	1	1	4
OG0004733	1	1	1	1	4
OG0004734	2	0	2	0	4
OG0004735	1	1	1	1	4
OG0004736	1	1	1	1	4
OG0004737	1	1	1	1	4
OG0004738	1	1	1	1	4
OG0004739	1	1	1	1	4
OG0004740	1	1	1	1	4
OG0004741	1	1	1	1	4
OG0004742	1	1	1	1	4
OG0004743	3	1	0	0	4
OG0004744	1	1	1	1	4
OG0004745	1	1	1	1	4
OG0004746	1	1	1	1	4
OG0004747	1	1	1	1	4
OG0004748	1	1	2	0	4
OG0004749	1	1	1	1	4
OG0004750	1	1	1	1	4
OG0004751	1	1	1	1	4
OG0004752	2	1	1	0	4
OG0004753	1	0	1	2	4
OG0004754	1	0	1	2	4
OG0004755	1	1	1	1	4
OG0004756	1	1	1	1	4
OG0004757	1	1	1	1	4
OG0004758	1	1	1	1	4
OG0004759	1	1	1	1	4
OG0004760	1	1	1	1	4
OG0004761	1	1	1	1	4
OG0004762	1	1	1	1	4
OG0004763	1	1	1	1	4
OG0004764	1	1	2	0	4
OG0004765	1	1	1	1	4
OG0004766	1	1	1	1	4
OG0004767	1	1	1	1	4
OG0004768	1	1	1	1	4
OG0004769	1	2	1	0	4
OG0004770	1	1	1	1	4
OG0004771	1	1	1	1	4
OG0004772	1	1	1	1	4
OG0004773	2	1	1	0	4
OG0004774	1	1	1	1	4
OG0004775	1	1	1	1	4
OG0004776	1	1	1	1	4
OG0004777	1	1	1	1	4
OG0004778	1	1	1	1	4
OG0004779	1	1	1	1	4
OG0004780	1	1	1	1	4
OG0004781	1	1	1	1	4
OG0004782	1	1	1	1	4
OG0004783	1	1	1	1	4
OG0004784	1	1	1	1	4
OG0004785	1	1	1	1	4
OG0004786	1	1	1	1	4
OG0004787	1	1	1	1	4
OG0004788	1	1	1	1	4
OG0004789	2	1	1	0	4
OG0004790	3	1	0	0	4
OG0004791	1	1	1	1	4
OG0004792	1	1	1	1	4
OG0004793	1	1	1	1	4
OG0004794	1	1	1	1	4
OG0004795	2	1	0	1	4
OG0004796	1	1	1	1	4
OG0004797	1	1	1	1	4
OG0004798	1	1	1	1	4
OG0004799	1	1	1	1	4
OG0004800	1	1	1	1	4
OG0004801	1	1	1	1	4
OG0004802	1	1	1	1	4
OG0004803	1	1	1	1	4
OG0004804	1	1	1	1	4
OG0004805	1	1	1	1	4
OG0004806	1	1	1	1	4
OG0004807	1	1	1	1	4
OG0004808	1	1	1	1	4
OG0004809	1	1	1	1	4
OG0004810	4	0	0	0	4
OG0004811	1	1	1	1	4
OG0004812	1	1	1	1	4
OG0004813	1	1	1	1	4
OG0004814	1	1	1	1	4
OG0004815	1	1	1	1	4
OG0004816	1	1	1	1	4
OG0004817	1	1	1	1	4
OG0004818	1	1	1	1	4
OG0004819	1	1	1	1	4
OG0004820	4	0	0	0	4
OG0004821	1	1	1	1	4
OG0004822	1	1	1	1	4
OG0004823	2	1	1	0	4
OG0004824	1	1	1	1	4
OG0004825	1	1	1	1	4
OG0004826	1	1	1	1	4
OG0004827	1	1	1	1	4
OG0004828	1	1	1	1	4
OG0004829	1	1	1	1	4
OG0004830	1	1	1	1	4
OG0004831	1	1	1	1	4
OG0004832	1	1	1	1	4
OG0004833	1	1	1	1	4
OG0004834	1	1	1	1	4
OG0004835	1	1	1	1	4
OG0004836	2	1	1	0	4
OG0004837	1	1	1	1	4
OG0004838	1	1	1	1	4
OG0004839	1	1	1	1	4
OG0004840	1	1	1	1	4
OG0004841	1	1	1	1	4
OG0004842	1	1	1	1	4
OG0004843	1	1	1	1	4
OG0004844	1	1	1	1	4
OG0004845	1	1	1	1	4
OG0004846	1	1	1	1	4
OG0004847	1	1	1	1	4
OG0004848	1	1	1	1	4
OG0004849	1	1	1	1	4
OG0004850	1	1	1	1	4
OG0004851	1	1	1	1	4
OG0004852	1	1	1	1	4
OG0004853	1	1	1	1	4
OG0004854	2	1	1	0	4
OG0004855	1	1	1	1	4
OG0004856	1	1	1	1	4
OG0004857	1	1	1	1	4
OG0004858	1	1	1	1	4
OG0004859	1	1	1	1	4
OG0004860	1	1	1	1	4
OG0004861	1	1	1	1	4
OG0004862	1	1	1	1	4
OG0004863	1	1	1	1	4
OG0004864	1	1	1	1	4
OG0004865	1	1	1	1	4
OG0004866	1	1	1	1	4
OG0004867	1	1	2	0	4
OG0004868	4	0	0	0	4
OG0004869	1	1	1	1	4
OG0004870	1	1	1	1	4
OG0004871	1	1	2	0	4
OG0004872	1	1	1	1	4
OG0004873	1	1	1	1	4
OG0004874	1	1	1	1	4
OG0004875	1	1	1	1	4
OG0004876	4	0	0	0	4
OG0004877	1	1	1	1	4
OG0004878	1	1	1	1	4
OG0004879	1	1	1	1	4
OG0004880	1	1	1	1	4
OG0004881	1	1	1	1	4
OG0004882	1	1	1	1	4
OG0004883	1	1	1	1	4
OG0004884	1	1	1	1	4
OG0004885	1	1	1	1	4
OG0004886	1	1	1	1	4
OG0004887	1	1	1	1	4
OG0004888	1	1	1	1	4
OG0004889	1	1	1	1	4
OG0004890	1	1	1	1	4
OG0004891	1	1	1	1	4
OG0004892	1	1	1	1	4
OG0004893	1	1	1	1	4
OG0004894	1	1	1	1	4
OG0004895	1	1	1	1	4
OG0004896	1	1	1	1	4
OG0004897	1	1	1	1	4
OG0004898	1	1	1	1	4
OG0004899	1	1	1	1	4
OG0004900	1	1	1	1	4
OG0004901	1	1	1	1	4
OG0004902	1	1	1	1	4
OG0004903	1	1	1	1	4
OG0004904	1	1	1	1	4
OG0004905	1	1	1	1	4
OG0004906	1	1	1	1	4
OG0004907	1	1	2	0	4
OG0004908	1	1	1	1	4
OG0004909	1	1	1	1	4
OG0004910	1	1	1	1	4
OG0004911	1	1	1	1	4
OG0004912	2	1	1	0	4
OG0004913	1	1	1	1	4
OG0004914	1	1	1	1	4
OG0004915	1	1	1	1	4
OG0004916	1	1	1	1	4
OG0004917	1	1	1	1	4
OG0004918	1	1	1	1	4
OG0004919	1	1	1	1	4
OG0004920	1	1	1	1	4
OG0004921	1	1	1	1	4
OG0004922	1	1	1	1	4
OG0004923	1	1	1	1	4
OG0004924	1	1	1	1	4
OG0004925	1	1	1	1	4
OG0004926	1	1	1	1	4
OG0004927	1	0	1	2	4
OG0004928	1	1	1	1	4
OG0004929	1	1	1	1	4
OG0004930	1	1	1	1	4
OG0004931	1	1	1	1	4
OG0004932	4	0	0	0	4
OG0004933	2	1	1	0	4
OG0004934	1	1	1	1	4
OG0004935	4	0	0	0	4
OG0004936	1	1	1	1	4
OG0004937	1	1	1	1	4
OG0004938	1	1	1	1	4
OG0004939	1	1	1	1	4
OG0004940	1	1	1	1	4
OG0004941	1	1	1	1	4
OG0004942	1	1	1	1	4
OG0004943	1	1	1	1	4
OG0004944	1	1	1	1	4
OG0004945	1	1	1	1	4
OG0004946	2	1	1	0	4
OG0004947	1	1	1	1	4
OG0004948	1	1	1	1	4
OG0004949	1	1	1	1	4
OG0004950	1	1	1	1	4
OG0004951	1	1	1	1	4
OG0004952	1	1	1	1	4
OG0004953	1	1	1	1	4
OG0004954	2	1	1	0	4
OG0004955	4	0	0	0	4
OG0004956	1	1	1	1	4
OG0004957	1	1	1	1	4
OG0004958	1	1	1	1	4
OG0004959	1	1	1	1	4
OG0004960	1	1	1	1	4
OG0004961	1	1	1	1	4
OG0004962	1	1	1	1	4
OG0004963	1	1	1	1	4
OG0004964	1	1	1	1	4
OG0004965	1	1	1	1	4
OG0004966	1	1	1	1	4
OG0004967	1	1	1	1	4
OG0004968	1	1	1	1	4
OG0004969	1	1	1	1	4
OG0004970	1	1	1	1	4
OG0004971	1	1	1	1	4
OG0004972	1	1	1	1	4
OG0004973	1	1	1	1	4
OG0004974	1	1	1	1	4
OG0004975	1	1	1	1	4
OG0004976	1	1	0	2	4
OG0004977	1	1	1	1	4
OG0004978	2	1	1	0	4
OG0004979	1	1	1	1	4
OG0004980	1	1	1	1	4
OG0004981	1	1	1	1	4
OG0004982	1	1	1	1	4
OG0004983	1	1	1	1	4
OG0004984	1	1	1	1	4
OG0004985	2	1	1	0	4
OG0004986	1	1	1	1	4
OG0004987	1	1	1	1	4
OG0004988	1	1	1	1	4
OG0004989	1	1	1	1	4
OG0004990	2	1	0	1	4
OG0004991	1	1	1	1	4
OG0004992	1	1	1	1	4
OG0004993	1	1	1	1	4
OG0004994	1	1	1	1	4
OG0004995	1	1	1	1	4
OG0004996	1	1	1	1	4
OG0004997	1	1	1	1	4
OG0004998	1	1	1	1	4
OG0004999	1	1	1	1	4
OG0005000	1	1	1	1	4
OG0005001	1	1	1	1	4
OG0005002	4	0	0	0	4
OG0005003	1	1	1	1	4
OG0005004	1	1	1	1	4
OG0005005	1	1	1	1	4
OG0005006	1	1	1	1	4
OG0005007	1	1	1	1	4
OG0005008	1	1	1	1	4
OG0005009	1	1	1	1	4
OG0005010	1	1	1	1	4
OG0005011	1	1	1	1	4
OG0005012	1	1	1	1	4
OG0005013	1	1	1	1	4
OG0005014	1	1	1	1	4
OG0005015	1	1	1	1	4
OG0005016	1	1	1	1	4
OG0005017	1	1	1	1	4
OG0005018	1	1	1	1	4
OG0005019	1	1	1	1	4
OG0005020	1	1	1	1	4
OG0005021	1	1	1	1	4
OG0005022	1	1	1	1	4
OG0005023	1	1	1	1	4
OG0005024	1	1	1	1	4
OG0005025	1	1	1	1	4
OG0005026	1	1	1	1	4
OG0005027	1	1	1	1	4
OG0005028	1	1	1	1	4
OG0005029	1	1	1	1	4
OG0005030	1	1	1	1	4
OG0005031	1	1	1	1	4
OG0005032	1	1	1	1	4
OG0005033	1	1	1	1	4
OG0005034	1	1	1	1	4
OG0005035	1	1	1	1	4
OG0005036	1	1	1	1	4
OG0005037	1	3	0	0	4
OG0005038	1	1	1	1	4
OG0005039	1	1	1	1	4
OG0005040	1	1	1	1	4
OG0005041	1	1	1	1	4
OG0005042	2	1	1	0	4
OG0005043	1	1	1	1	4
OG0005044	1	1	1	1	4
OG0005045	1	1	1	1	4
OG0005046	1	1	1	1	4
OG0005047	1	1	1	1	4
OG0005048	1	1	1	1	4
OG0005049	1	1	1	1	4
OG0005050	1	1	1	1	4
OG0005051	1	1	1	1	4
OG0005052	1	1	1	1	4
OG0005053	1	1	1	1	4
OG0005054	1	1	1	1	4
OG0005055	1	1	1	1	4
OG0005056	1	1	1	1	4
OG0005057	1	1	1	1	4
OG0005058	1	1	1	1	4
OG0005059	1	1	1	1	4
OG0005060	1	1	1	1	4
OG0005061	1	1	1	1	4
OG0005062	1	1	1	1	4
OG0005063	4	0	0	0	4
OG0005064	1	1	1	1	4
OG0005065	1	1	1	1	4
OG0005066	1	1	1	1	4
OG0005067	1	1	1	1	4
OG0005068	1	1	1	1	4
OG0005069	1	1	1	1	4
OG0005070	4	0	0	0	4
OG0005071	1	1	1	1	4
OG0005072	1	1	1	1	4
OG0005073	1	1	1	1	4
OG0005074	1	1	1	1	4
OG0005075	1	1	1	1	4
OG0005076	1	1	1	1	4
OG0005077	1	1	1	1	4
OG0005078	1	1	1	1	4
OG0005079	1	1	1	1	4
OG0005080	1	1	1	1	4
OG0005081	1	1	1	1	4
OG0005082	1	1	1	1	4
OG0005083	1	1	1	1	4
OG0005084	1	1	1	1	4
OG0005085	1	1	1	1	4
OG0005086	1	1	1	1	4
OG0005087	1	1	1	1	4
OG0005088	1	1	1	1	4
OG0005089	1	1	1	1	4
OG0005090	1	1	1	1	4
OG0005091	1	1	1	1	4
OG0005092	1	1	1	1	4
OG0005093	1	1	2	0	4
OG0005094	1	1	1	1	4
OG0005095	1	1	1	1	4
OG0005096	1	1	1	1	4
OG0005097	1	1	1	1	4
OG0005098	1	1	1	1	4
OG0005099	1	1	1	1	4
OG0005100	1	1	1	1	4
OG0005101	1	1	1	1	4
OG0005102	1	1	1	1	4
OG0005103	1	1	1	1	4
OG0005104	1	1	1	1	4
OG0005105	1	1	1	1	4
OG0005106	1	1	1	1	4
OG0005107	1	1	1	1	4
OG0005108	1	1	1	1	4
OG0005109	1	1	1	1	4
OG0005110	1	1	1	1	4
OG0005111	1	1	2	0	4
OG0005112	2	1	1	0	4
OG0005113	1	2	1	0	4
OG0005114	2	1	1	0	4
OG0005115	1	1	1	1	4
OG0005116	1	1	1	1	4
OG0005117	1	1	1	1	4
OG0005118	1	0	1	2	4
OG0005119	1	1	1	1	4
OG0005120	1	1	1	1	4
OG0005121	1	1	1	1	4
OG0005122	1	1	1	1	4
OG0005123	1	1	1	1	4
OG0005124	1	1	1	1	4
OG0005125	1	1	1	1	4
OG0005126	1	1	1	1	4
OG0005127	1	1	1	1	4
OG0005128	1	1	1	1	4
OG0005129	1	1	1	1	4
OG0005130	1	1	1	1	4
OG0005131	1	1	1	1	4
OG0005132	2	1	1	0	4
OG0005133	1	1	1	1	4
OG0005134	1	1	1	1	4
OG0005135	1	1	1	1	4
OG0005136	1	1	1	1	4
OG0005137	1	1	1	1	4
OG0005138	1	1	1	1	4
OG0005139	1	1	1	1	4
OG0005140	1	1	1	1	4
OG0005141	1	1	1	1	4
OG0005142	1	1	2	0	4
OG0005143	1	1	1	1	4
OG0005144	1	1	1	1	4
OG0005145	1	1	1	1	4
OG0005146	1	1	1	1	4
OG0005147	1	1	1	1	4
OG0005148	2	1	1	0	4
OG0005149	1	1	1	1	4
OG0005150	1	1	1	1	4
OG0005151	1	1	1	1	4
OG0005152	1	1	1	1	4
OG0005153	1	1	1	1	4
OG0005154	1	1	1	1	4
OG0005155	1	1	1	1	4
OG0005156	1	1	1	1	4
OG0005157	1	1	1	1	4
OG0005158	1	1	1	1	4
OG0005159	1	1	1	1	4
OG0005160	4	0	0	0	4
OG0005161	1	1	1	1	4
OG0005162	1	1	1	1	4
OG0005163	1	1	1	1	4
OG0005164	1	1	1	1	4
OG0005165	3	1	0	0	4
OG0005166	2	1	1	0	4
OG0005167	2	1	1	0	4
OG0005168	1	1	1	1	4
OG0005169	1	1	1	1	4
OG0005170	1	1	1	1	4
OG0005171	1	1	1	1	4
OG0005172	1	1	1	1	4
OG0005173	2	1	1	0	4
OG0005174	2	1	1	0	4
OG0005175	1	1	1	1	4
OG0005176	1	1	1	1	4
OG0005177	1	1	1	1	4
OG0005178	1	1	1	1	4
OG0005179	1	1	1	1	4
OG0005180	1	1	1	1	4
OG0005181	2	1	1	0	4
OG0005182	1	1	1	1	4
OG0005183	1	2	1	0	4
OG0005184	1	1	1	1	4
OG0005185	1	1	1	1	4
OG0005186	1	1	1	1	4
OG0005187	1	1	1	1	4
OG0005188	1	1	1	1	4
OG0005189	1	1	1	1	4
OG0005190	1	1	1	1	4
OG0005191	1	1	1	1	4
OG0005192	1	1	1	1	4
OG0005193	1	1	1	1	4
OG0005194	3	1	0	0	4
OG0005195	1	1	1	1	4
OG0005196	4	0	0	0	4
OG0005197	1	1	1	1	4
OG0005198	1	1	1	1	4
OG0005199	1	1	1	1	4
OG0005200	1	1	1	1	4
OG0005201	1	1	1	1	4
OG0005202	1	1	1	1	4
OG0005203	1	1	1	1	4
OG0005204	1	1	1	1	4
OG0005205	1	1	1	1	4
OG0005206	1	1	1	1	4
OG0005207	1	1	1	1	4
OG0005208	1	1	1	1	4
OG0005209	1	1	1	1	4
OG0005210	1	1	1	1	4
OG0005211	1	1	1	1	4
OG0005212	1	1	1	1	4
OG0005213	1	1	1	1	4
OG0005214	1	1	1	1	4
OG0005215	1	1	1	1	4
OG0005216	1	1	1	1	4
OG0005217	1	1	1	1	4
OG0005218	1	1	1	1	4
OG0005219	1	1	1	1	4
OG0005220	1	1	1	1	4
OG0005221	1	1	1	1	4
OG0005222	1	1	1	1	4
OG0005223	1	1	1	1	4
OG0005224	1	1	1	1	4
OG0005225	1	1	1	1	4
OG0005226	1	1	1	1	4
OG0005227	1	1	1	1	4
OG0005228	1	1	1	1	4
OG0005229	4	0	0	0	4
OG0005230	1	1	1	1	4
OG0005231	1	1	1	1	4
OG0005232	1	1	1	1	4
OG0005233	1	1	1	1	4
OG0005234	1	1	1	1	4
OG0005235	1	1	1	1	4
OG0005236	1	1	1	1	4
OG0005237	1	1	1	1	4
OG0005238	2	1	1	0	4
OG0005239	1	1	1	1	4
OG0005240	1	1	1	1	4
OG0005241	1	1	1	1	4
OG0005242	1	1	1	1	4
OG0005243	1	1	1	1	4
OG0005244	1	1	1	1	4
OG0005245	1	1	1	1	4
OG0005246	1	1	1	1	4
OG0005247	4	0	0	0	4
OG0005248	1	1	1	1	4
OG0005249	1	1	2	0	4
OG0005250	1	1	1	1	4
OG0005251	1	1	1	1	4
OG0005252	1	1	1	1	4
OG0005253	1	1	1	1	4
OG0005254	1	1	1	1	4
OG0005255	1	1	1	1	4
OG0005256	1	1	1	1	4
OG0005257	1	1	1	1	4
OG0005258	1	1	1	1	4
OG0005259	1	1	1	1	4
OG0005260	1	1	1	1	4
OG0005261	1	1	1	1	4
OG0005262	1	1	1	1	4
OG0005263	1	1	1	1	4
OG0005264	1	1	1	1	4
OG0005265	1	1	1	1	4
OG0005266	1	1	1	1	4
OG0005267	1	1	1	1	4
OG0005268	1	1	1	1	4
OG0005269	1	1	1	1	4
OG0005270	1	1	1	1	4
OG0005271	1	1	1	1	4
OG0005272	1	1	1	1	4
OG0005273	1	1	1	1	4
OG0005274	1	1	1	1	4
OG0005275	1	1	1	1	4
OG0005276	1	1	1	1	4
OG0005277	1	1	1	1	4
OG0005278	1	1	1	1	4
OG0005279	1	1	1	1	4
OG0005280	1	1	1	1	4
OG0005281	1	1	1	1	4
OG0005282	1	1	1	1	4
OG0005283	1	1	1	1	4
OG0005284	1	1	1	1	4
OG0005285	1	1	1	1	4
OG0005286	1	1	1	1	4
OG0005287	1	1	1	1	4
OG0005288	1	1	1	1	4
OG0005289	1	1	1	1	4
OG0005290	1	1	1	1	4
OG0005291	1	1	1	1	4
OG0005292	1	1	1	1	4
OG0005293	1	1	1	1	4
OG0005294	1	1	1	1	4
OG0005295	1	1	1	1	4
OG0005296	1	1	1	1	4
OG0005297	1	1	2	0	4
OG0005298	1	1	1	1	4
OG0005299	1	1	1	1	4
OG0005300	2	1	1	0	4
OG0005301	1	1	1	1	4
OG0005302	1	1	1	1	4
OG0005303	1	1	1	1	4
OG0005304	1	1	1	1	4
OG0005305	1	1	1	1	4
OG0005306	1	1	1	1	4
OG0005307	1	1	1	1	4
OG0005308	1	1	1	1	4
OG0005309	1	1	1	1	4
OG0005310	1	1	1	1	4
OG0005311	1	1	1	1	4
OG0005312	1	1	1	1	4
OG0005313	1	1	1	1	4
OG0005314	1	1	1	1	4
OG0005315	1	1	1	1	4
OG0005316	1	1	1	1	4
OG0005317	1	1	1	1	4
OG0005318	1	1	1	1	4
OG0005319	1	1	1	1	4
OG0005320	1	1	1	1	4
OG0005321	1	1	2	0	4
OG0005322	1	1	1	1	4
OG0005323	1	1	1	1	4
OG0005324	1	1	1	1	4
OG0005325	1	1	1	1	4
OG0005326	1	1	1	1	4
OG0005327	1	1	1	1	4
OG0005328	1	1	1	1	4
OG0005329	1	1	1	1	4
OG0005330	1	1	1	1	4
OG0005331	1	1	1	1	4
OG0005332	1	1	1	1	4
OG0005333	1	1	1	1	4
OG0005334	2	0	1	1	4
OG0005335	1	1	1	1	4
OG0005336	1	1	1	1	4
OG0005337	1	1	1	1	4
OG0005338	1	1	1	1	4
OG0005339	1	1	1	1	4
OG0005340	2	1	1	0	4
OG0005341	1	1	1	1	4
OG0005342	1	1	1	1	4
OG0005343	1	1	1	1	4
OG0005344	1	1	1	1	4
OG0005345	1	1	1	1	4
OG0005346	1	1	1	1	4
OG0005347	1	1	1	1	4
OG0005348	1	1	1	1	4
OG0005349	1	1	1	1	4
OG0005350	1	1	1	1	4
OG0005351	1	1	1	1	4
OG0005352	1	3	0	0	4
OG0005353	1	1	1	1	4
OG0005354	1	1	1	1	4
OG0005355	1	1	1	1	4
OG0005356	1	1	1	1	4
OG0005357	4	0	0	0	4
OG0005358	1	1	1	1	4
OG0005359	1	1	1	1	4
OG0005360	1	1	1	1	4
OG0005361	1	1	1	1	4
OG0005362	1	1	1	1	4
OG0005363	1	1	1	1	4
OG0005364	1	1	1	1	4
OG0005365	3	0	1	0	4
OG0005366	1	1	1	1	4
OG0005367	1	1	1	1	4
OG0005368	1	1	1	1	4
OG0005369	1	1	1	1	4
OG0005370	1	1	1	1	4
OG0005371	1	1	1	1	4
OG0005372	1	1	1	1	4
OG0005373	1	1	1	1	4
OG0005374	1	1	1	1	4
OG0005375	1	1	1	1	4
OG0005376	1	1	1	1	4
OG0005377	1	1	1	1	4
OG0005378	1	1	1	1	4
OG0005379	1	1	1	1	4
OG0005380	1	1	1	1	4
OG0005381	1	1	1	1	4
OG0005382	1	1	1	1	4
OG0005383	1	1	1	1	4
OG0005384	1	1	1	1	4
OG0005385	1	1	1	1	4
OG0005386	1	1	1	1	4
OG0005387	2	1	1	0	4
OG0005388	1	1	1	1	4
OG0005389	1	1	1	1	4
OG0005390	1	1	1	1	4
OG0005391	1	1	1	1	4
OG0005392	1	1	1	1	4
OG0005393	1	1	1	1	4
OG0005394	1	1	1	1	4
OG0005395	1	1	1	1	4
OG0005396	1	1	1	1	4
OG0005397	1	1	1	1	4
OG0005398	1	1	1	1	4
OG0005399	1	1	1	1	4
OG0005400	1	1	1	1	4
OG0005401	1	1	1	1	4
OG0005402	1	1	1	1	4
OG0005403	1	1	1	1	4
OG0005404	1	1	1	1	4
OG0005405	1	1	1	1	4
OG0005406	1	1	1	1	4
OG0005407	1	1	1	1	4
OG0005408	1	1	1	1	4
OG0005409	1	1	1	1	4
OG0005410	1	1	1	1	4
OG0005411	1	1	1	1	4
OG0005412	1	1	1	1	4
OG0005413	3	0	0	1	4
OG0005414	1	1	1	1	4
OG0005415	1	1	1	1	4
OG0005416	1	1	1	1	4
OG0005417	1	1	1	1	4
OG0005418	1	1	1	1	4
OG0005419	1	1	1	1	4
OG0005420	1	1	1	1	4
OG0005421	1	1	1	1	4
OG0005422	1	1	1	1	4
OG0005423	1	1	1	1	4
OG0005424	1	1	1	1	4
OG0005425	1	1	1	1	4
OG0005426	1	1	1	1	4
OG0005427	1	1	1	1	4
OG0005428	1	1	1	1	4
OG0005429	1	1	1	1	4
OG0005430	1	1	1	1	4
OG0005431	1	1	1	1	4
OG0005432	1	1	1	1	4
OG0005433	1	1	1	1	4
OG0005434	1	1	1	1	4
OG0005435	2	1	0	1	4
OG0005436	1	1	1	1	4
OG0005437	1	1	1	1	4
OG0005438	1	1	1	1	4
OG0005439	1	1	1	1	4
OG0005440	1	1	1	1	4
OG0005441	1	1	1	1	4
OG0005442	1	1	1	1	4
OG0005443	1	1	1	1	4
OG0005444	1	1	1	1	4
OG0005445	1	1	1	1	4
OG0005446	1	0	2	1	4
OG0005447	1	1	1	1	4
OG0005448	1	1	1	1	4
OG0005449	1	1	1	1	4
OG0005450	1	1	1	1	4
OG0005451	1	1	1	1	4
OG0005452	2	1	1	0	4
OG0005453	1	1	1	1	4
OG0005454	1	1	1	1	4
OG0005455	1	1	1	1	4
OG0005456	1	1	1	1	4
OG0005457	1	1	1	1	4
OG0005458	1	1	1	1	4
OG0005459	2	2	0	0	4
OG0005460	1	1	1	1	4
OG0005461	1	1	1	1	4
OG0005462	1	1	1	1	4
OG0005463	1	1	1	1	4
OG0005464	1	1	1	1	4
OG0005465	1	1	1	1	4
OG0005466	1	1	1	1	4
OG0005467	1	1	1	1	4
OG0005468	1	1	1	1	4
OG0005469	1	1	1	1	4
OG0005470	1	1	1	1	4
OG0005471	1	1	1	1	4
OG0005472	1	1	1	1	4
OG0005473	1	1	2	0	4
OG0005474	2	1	0	1	4
OG0005475	2	1	1	0	4
OG0005476	1	1	1	1	4
OG0005477	2	1	0	1	4
OG0005478	1	1	1	1	4
OG0005479	1	1	1	1	4
OG0005480	1	1	1	1	4
OG0005481	1	1	1	1	4
OG0005482	1	1	1	1	4
OG0005483	1	1	1	1	4
OG0005484	1	1	1	1	4
OG0005485	1	1	1	1	4
OG0005486	1	1	1	1	4
OG0005487	1	1	1	1	4
OG0005488	1	1	1	1	4
OG0005489	1	1	1	1	4
OG0005490	1	1	1	1	4
OG0005491	1	1	1	1	4
OG0005492	1	1	1	1	4
OG0005493	1	1	1	1	4
OG0005494	1	1	1	1	4
OG0005495	1	1	1	1	4
OG0005496	1	1	1	1	4
OG0005497	1	1	2	0	4
OG0005498	3	1	0	0	4
OG0005499	1	1	1	1	4
OG0005500	1	1	1	1	4
OG0005501	1	1	1	1	4
OG0005502	1	1	1	1	4
OG0005503	1	1	1	1	4
OG0005504	1	1	1	1	4
OG0005505	1	1	1	1	4
OG0005506	1	1	1	1	4
OG0005507	1	1	1	1	4
OG0005508	1	1	1	1	4
OG0005509	1	1	1	1	4
OG0005510	1	1	1	1	4
OG0005511	1	1	1	1	4
OG0005512	1	1	1	1	4
OG0005513	1	1	1	1	4
OG0005514	1	1	1	1	4
OG0005515	1	1	1	1	4
OG0005516	1	1	1	1	4
OG0005517	1	1	1	1	4
OG0005518	1	1	1	1	4
OG0005519	1	1	1	1	4
OG0005520	1	1	1	1	4
OG0005521	1	1	1	1	4
OG0005522	1	1	1	1	4
OG0005523	1	1	1	1	4
OG0005524	1	1	2	0	4
OG0005525	1	1	1	1	4
OG0005526	1	1	1	1	4
OG0005527	1	1	1	1	4
OG0005528	1	1	1	1	4
OG0005529	1	1	1	1	4
OG0005530	1	1	1	1	4
OG0005531	1	1	1	1	4
OG0005532	1	1	1	1	4
OG0005533	1	1	1	1	4
OG0005534	1	1	1	1	4
OG0005535	1	2	1	0	4
OG0005536	1	1	1	1	4
OG0005537	1	1	1	1	4
OG0005538	1	1	1	1	4
OG0005539	1	1	1	1	4
OG0005540	1	1	1	1	4
OG0005541	1	1	1	1	4
OG0005542	1	1	1	1	4
OG0005543	1	1	1	1	4
OG0005544	1	1	1	1	4
OG0005545	1	1	1	1	4
OG0005546	1	1	1	1	4
OG0005547	1	1	1	1	4
OG0005548	1	1	1	1	4
OG0005549	1	2	1	0	4
OG0005550	1	1	1	1	4
OG0005551	1	1	1	1	4
OG0005552	1	1	1	1	4
OG0005553	1	1	1	1	4
OG0005554	1	1	1	1	4
OG0005555	1	1	1	1	4
OG0005556	4	0	0	0	4
OG0005557	1	1	1	1	4
OG0005558	1	1	1	1	4
OG0005559	1	1	1	1	4
OG0005560	1	1	1	1	4
OG0005561	1	1	2	0	4
OG0005562	1	1	1	1	4
OG0005563	1	1	1	1	4
OG0005564	1	1	1	1	4
OG0005565	2	2	0	0	4
OG0005566	1	1	1	1	4
OG0005567	1	1	1	1	4
OG0005568	1	1	1	1	4
OG0005569	1	1	1	1	4
OG0005570	1	1	1	1	4
OG0005571	1	1	1	1	4
OG0005572	1	1	1	1	4
OG0005573	1	1	1	1	4
OG0005574	2	1	1	0	4
OG0005575	1	1	1	1	4
OG0005576	1	1	1	1	4
OG0005577	1	1	1	1	4
OG0005578	1	1	1	1	4
OG0005579	3	1	0	0	4
OG0005580	1	1	1	1	4
OG0005581	1	1	1	1	4
OG0005582	1	1	1	1	4
OG0005583	1	1	1	1	4
OG0005584	1	1	1	1	4
OG0005585	1	0	2	1	4
OG0005586	1	1	1	1	4
OG0005587	1	1	1	1	4
OG0005588	1	1	1	1	4
OG0005589	1	1	1	1	4
OG0005590	1	1	1	1	4
OG0005591	1	1	1	1	4
OG0005592	1	1	1	1	4
OG0005593	1	1	1	1	4
OG0005594	1	1	1	1	4
OG0005595	1	1	1	1	4
OG0005596	1	1	1	1	4
OG0005597	1	1	1	1	4
OG0005598	1	1	1	1	4
OG0005599	1	1	1	1	4
OG0005600	1	1	1	1	4
OG0005601	1	1	1	1	4
OG0005602	1	1	1	1	4
OG0005603	1	1	1	1	4
OG0005604	1	1	1	1	4
OG0005605	1	1	1	1	4
OG0005606	1	1	1	1	4
OG0005607	1	1	1	1	4
OG0005608	1	1	2	0	4
OG0005609	1	1	1	1	4
OG0005610	1	1	1	1	4
OG0005611	1	1	1	1	4
OG0005612	1	1	1	1	4
OG0005613	1	1	1	1	4
OG0005614	2	1	1	0	4
OG0005615	1	1	1	1	4
OG0005616	1	1	1	1	4
OG0005617	2	0	1	1	4
OG0005618	1	1	1	1	4
OG0005619	1	1	1	1	4
OG0005620	1	1	1	1	4
OG0005621	1	1	1	1	4
OG0005622	1	1	1	1	4
OG0005623	1	1	1	1	4
OG0005624	1	1	1	1	4
OG0005625	1	1	1	1	4
OG0005626	1	1	1	1	4
OG0005627	1	1	1	1	4
OG0005628	1	1	1	1	4
OG0005629	1	1	1	1	4
OG0005630	1	1	1	1	4
OG0005631	1	1	1	1	4
OG0005632	1	1	1	1	4
OG0005633	1	1	1	1	4
OG0005634	1	1	1	1	4
OG0005635	1	1	1	1	4
OG0005636	1	1	1	1	4
OG0005637	2	1	1	0	4
OG0005638	1	1	1	1	4
OG0005639	1	1	1	1	4
OG0005640	1	1	1	1	4
OG0005641	1	1	1	1	4
OG0005642	1	1	1	1	4
OG0005643	2	1	1	0	4
OG0005644	1	1	1	1	4
OG0005645	1	1	1	1	4
OG0005646	1	1	1	1	4
OG0005647	1	1	1	1	4
OG0005648	1	1	1	1	4
OG0005649	1	1	1	1	4
OG0005650	1	1	1	1	4
OG0005651	2	1	1	0	4
OG0005652	1	1	1	1	4
OG0005653	1	1	1	1	4
OG0005654	1	1	1	1	4
OG0005655	1	1	1	1	4
OG0005656	1	1	1	1	4
OG0005657	1	1	1	1	4
OG0005658	1	0	1	2	4
OG0005659	1	1	1	1	4
OG0005660	1	1	1	1	4
OG0005661	1	1	1	1	4
OG0005662	1	1	1	1	4
OG0005663	1	1	1	1	4
OG0005664	1	1	1	1	4
OG0005665	1	1	1	1	4
OG0005666	1	1	1	1	4
OG0005667	1	1	2	0	4
OG0005668	1	1	1	1	4
OG0005669	1	1	1	1	4
OG0005670	2	1	1	0	4
OG0005671	1	1	1	1	4
OG0005672	1	1	1	1	4
OG0005673	1	1	2	0	4
OG0005674	1	1	1	1	4
OG0005675	1	1	1	1	4
OG0005676	1	1	1	1	4
OG0005677	1	1	1	1	4
OG0005678	1	1	1	1	4
OG0005679	1	1	1	1	4
OG0005680	1	1	1	1	4
OG0005681	1	1	1	1	4
OG0005682	1	1	1	1	4
OG0005683	1	1	1	1	4
OG0005684	1	1	1	1	4
OG0005685	1	1	1	1	4
OG0005686	1	1	1	1	4
OG0005687	1	1	1	1	4
OG0005688	1	1	1	1	4
OG0005689	1	1	1	1	4
OG0005690	1	1	1	1	4
OG0005691	1	1	1	1	4
OG0005692	1	1	1	1	4
OG0005693	1	1	1	1	4
OG0005694	1	1	1	1	4
OG0005695	1	1	1	1	4
OG0005696	1	1	1	1	4
OG0005697	1	1	1	1	4
OG0005698	1	1	1	1	4
OG0005699	1	1	1	1	4
OG0005700	1	1	1	1	4
OG0005701	1	1	1	1	4
OG0005702	1	1	1	1	4
OG0005703	1	1	1	1	4
OG0005704	2	1	1	0	4
OG0005705	1	1	1	1	4
OG0005706	1	1	1	1	4
OG0005707	1	1	1	1	4
OG0005708	1	1	1	1	4
OG0005709	1	1	1	1	4
OG0005710	1	1	1	1	4
OG0005711	1	1	1	1	4
OG0005712	1	1	1	1	4
OG0005713	1	1	1	1	4
OG0005714	1	1	1	1	4
OG0005715	1	1	1	1	4
OG0005716	1	1	1	1	4
OG0005717	1	1	1	1	4
OG0005718	1	1	1	1	4
OG0005719	1	1	1	1	4
OG0005720	1	1	1	1	4
OG0005721	1	1	1	1	4
OG0005722	1	1	1	1	4
OG0005723	1	1	1	1	4
OG0005724	4	0	0	0	4
OG0005725	1	1	1	1	4
OG0005726	1	1	1	1	4
OG0005727	1	1	1	1	4
OG0005728	1	1	1	1	4
OG0005729	1	1	1	1	4
OG0005730	1	1	1	1	4
OG0005731	1	1	1	1	4
OG0005732	1	1	1	1	4
OG0005733	1	1	1	1	4
OG0005734	1	1	1	1	4
OG0005735	1	1	1	1	4
OG0005736	2	1	1	0	4
OG0005737	1	1	2	0	4
OG0005738	1	1	1	1	4
OG0005739	1	1	1	1	4
OG0005740	1	1	1	1	4
OG0005741	1	1	1	1	4
OG0005742	2	1	1	0	4
OG0005743	1	1	1	1	4
OG0005744	1	1	1	1	4
OG0005745	1	1	1	1	4
OG0005746	1	1	1	1	4
OG0005747	1	1	1	1	4
OG0005748	1	1	1	1	4
OG0005749	1	1	1	1	4
OG0005750	1	1	1	1	4
OG0005751	1	1	1	1	4
OG0005752	1	1	1	1	4
OG0005753	1	1	1	1	4
OG0005754	1	1	1	1	4
OG0005755	1	1	1	1	4
OG0005756	1	1	1	1	4
OG0005757	1	1	1	1	4
OG0005758	1	1	1	1	4
OG0005759	1	1	1	1	4
OG0005760	1	1	2	0	4
OG0005761	1	1	1	1	4
OG0005762	1	1	1	1	4
OG0005763	1	1	1	1	4
OG0005764	1	1	1	1	4
OG0005765	1	1	1	1	4
OG0005766	1	1	1	1	4
OG0005767	1	1	1	1	4
OG0005768	1	1	1	1	4
OG0005769	1	1	1	1	4
OG0005770	1	1	1	1	4
OG0005771	1	1	1	1	4
OG0005772	1	1	1	1	4
OG0005773	1	1	1	1	4
OG0005774	1	1	1	1	4
OG0005775	1	1	1	1	4
OG0005776	2	1	1	0	4
OG0005777	1	1	1	1	4
OG0005778	1	1	1	1	4
OG0005779	1	1	1	1	4
OG0005780	1	1	1	1	4
OG0005781	2	1	0	1	4
OG0005782	1	1	1	1	4
OG0005783	1	1	1	1	4
OG0005784	1	1	1	1	4
OG0005785	1	1	1	1	4
OG0005786	1	1	1	1	4
OG0005787	1	1	1	1	4
OG0005788	1	1	1	1	4
OG0005789	1	1	1	1	4
OG0005790	1	1	2	0	4
OG0005791	1	1	1	1	4
OG0005792	1	1	1	1	4
OG0005793	1	1	1	1	4
OG0005794	1	1	1	1	4
OG0005795	1	1	1	1	4
OG0005796	1	1	1	1	4
OG0005797	1	1	1	1	4
OG0005798	1	1	1	1	4
OG0005799	1	1	1	1	4
OG0005800	1	1	1	1	4
OG0005801	1	1	1	1	4
OG0005802	1	1	1	1	4
OG0005803	1	1	1	1	4
OG0005804	1	1	1	1	4
OG0005805	1	1	1	1	4
OG0005806	2	1	1	0	4
OG0005807	1	1	1	1	4
OG0005808	1	1	1	1	4
OG0005809	1	1	1	1	4
OG0005810	1	1	1	1	4
OG0005811	2	0	2	0	4
OG0005812	1	1	1	1	4
OG0005813	1	1	1	1	4
OG0005814	1	1	1	1	4
OG0005815	1	1	1	1	4
OG0005816	1	1	1	1	4
OG0005817	1	1	1	1	4
OG0005818	1	1	1	1	4
OG0005819	1	1	1	1	4
OG0005820	1	1	1	1	4
OG0005821	1	1	1	1	4
OG0005822	1	1	1	1	4
OG0005823	1	1	1	1	4
OG0005824	1	1	1	1	4
OG0005825	1	1	1	1	4
OG0005826	1	1	2	0	4
OG0005827	1	1	1	1	4
OG0005828	1	1	1	1	4
OG0005829	1	1	1	1	4
OG0005830	1	1	2	0	4
OG0005831	1	1	1	1	4
OG0005832	1	1	1	1	4
OG0005833	1	1	1	1	4
OG0005834	1	1	1	1	4
OG0005835	1	1	1	1	4
OG0005836	1	1	1	1	4
OG0005837	1	1	1	1	4
OG0005838	1	1	1	1	4
OG0005839	1	1	1	1	4
OG0005840	1	1	1	1	4
OG0005841	1	1	1	1	4
OG0005842	1	1	1	1	4
OG0005843	1	1	1	1	4
OG0005844	1	1	1	1	4
OG0005845	1	1	1	1	4
OG0005846	1	1	1	1	4
OG0005847	1	1	1	1	4
OG0005848	1	1	1	1	4
OG0005849	1	1	2	0	4
OG0005850	1	1	1	1	4
OG0005851	1	1	1	1	4
OG0005852	1	1	1	1	4
OG0005853	2	2	0	0	4
OG0005854	1	1	1	1	4
OG0005855	1	1	1	1	4
OG0005856	1	1	1	1	4
OG0005857	1	1	1	1	4
OG0005858	1	1	1	1	4
OG0005859	1	1	1	1	4
OG0005860	1	1	1	1	4
OG0005861	1	1	1	1	4
OG0005862	1	1	1	1	4
OG0005863	1	1	1	1	4
OG0005864	1	1	1	1	4
OG0005865	1	1	1	1	4
OG0005866	1	1	1	1	4
OG0005867	1	1	1	1	4
OG0005868	1	1	1	1	4
OG0005869	1	2	1	0	4
OG0005870	1	1	1	1	4
OG0005871	1	1	1	1	4
OG0005872	1	1	1	1	4
OG0005873	1	1	1	1	4
OG0005874	2	1	1	0	4
OG0005875	1	1	1	1	4
OG0005876	1	1	1	1	4
OG0005877	1	1	1	1	4
OG0005878	1	1	1	1	4
OG0005879	1	1	2	0	4
OG0005880	2	1	1	0	4
OG0005881	3	0	1	0	4
OG0005882	1	1	1	1	4
OG0005883	1	1	1	1	4
OG0005884	1	1	1	1	4
OG0005885	1	1	1	1	4
OG0005886	1	1	1	1	4
OG0005887	1	1	1	1	4
OG0005888	1	1	1	1	4
OG0005889	4	0	0	0	4
OG0005890	1	1	1	1	4
OG0005891	1	1	1	1	4
OG0005892	1	1	1	1	4
OG0005893	1	1	1	1	4
OG0005894	1	1	1	1	4
OG0005895	1	1	1	1	4
OG0005896	1	1	1	1	4
OG0005897	1	1	1	1	4
OG0005898	1	1	1	1	4
OG0005899	3	1	0	0	4
OG0005900	1	1	1	1	4
OG0005901	4	0	0	0	4
OG0005902	1	1	1	1	4
OG0005903	3	1	0	0	4
OG0005904	1	1	2	0	4
OG0005905	1	1	1	1	4
OG0005906	1	1	1	1	4
OG0005907	1	1	1	1	4
OG0005908	1	1	1	1	4
OG0005909	1	1	1	1	4
OG0005910	1	3	0	0	4
OG0005911	1	1	1	1	4
OG0005912	1	1	1	1	4
OG0005913	1	1	1	1	4
OG0005914	1	1	1	1	4
OG0005915	1	1	1	1	4
OG0005916	1	1	1	1	4
OG0005917	1	1	1	1	4
OG0005918	1	1	1	1	4
OG0005919	1	1	1	1	4
OG0005920	1	1	1	1	4
OG0005921	1	1	1	1	4
OG0005922	1	1	1	1	4
OG0005923	1	1	1	1	4
OG0005924	1	1	1	1	4
OG0005925	1	1	1	1	4
OG0005926	1	2	1	0	4
OG0005927	1	1	1	1	4
OG0005928	1	1	1	1	4
OG0005929	1	1	1	1	4
OG0005930	1	1	1	1	4
OG0005931	1	1	1	1	4
OG0005932	2	1	1	0	4
OG0005933	1	1	1	1	4
OG0005934	1	1	1	1	4
OG0005935	1	1	1	1	4
OG0005936	1	1	1	1	4
OG0005937	1	1	1	1	4
OG0005938	1	1	1	1	4
OG0005939	1	1	1	1	4
OG0005940	1	1	1	1	4
OG0005941	1	1	1	1	4
OG0005942	1	1	1	1	4
OG0005943	1	1	1	1	4
OG0005944	1	1	1	1	4
OG0005945	1	1	1	1	4
OG0005946	1	2	1	0	4
OG0005947	1	1	1	1	4
OG0005948	1	1	1	1	4
OG0005949	1	1	1	1	4
OG0005950	1	1	1	1	4
OG0005951	1	1	1	1	4
OG0005952	1	2	1	0	4
OG0005953	1	1	1	1	4
OG0005954	1	1	1	1	4
OG0005955	1	1	1	1	4
OG0005956	1	1	1	1	4
OG0005957	1	1	1	1	4
OG0005958	1	1	1	1	4
OG0005959	1	1	1	1	4
OG0005960	1	1	1	1	4
OG0005961	1	1	1	1	4
OG0005962	1	1	1	1	4
OG0005963	2	1	1	0	4
OG0005964	1	1	1	1	4
OG0005965	1	1	1	1	4
OG0005966	1	1	1	1	4
OG0005967	2	1	1	0	4
OG0005968	1	1	1	1	4
OG0005969	1	1	1	1	4
OG0005970	1	1	1	1	4
OG0005971	1	1	1	1	4
OG0005972	2	1	1	0	4
OG0005973	4	0	0	0	4
OG0005974	1	1	1	1	4
OG0005975	1	1	1	1	4
OG0005976	1	1	1	1	4
OG0005977	1	1	1	1	4
OG0005978	1	1	1	1	4
OG0005979	1	1	1	1	4
OG0005980	1	1	1	1	4
OG0005981	2	1	1	0	4
OG0005982	1	1	1	1	4
OG0005983	1	1	1	1	4
OG0005984	1	1	1	1	4
OG0005985	1	1	1	1	4
OG0005986	1	1	1	1	4
OG0005987	1	1	1	1	4
OG0005988	1	1	1	1	4
OG0005989	1	1	1	1	4
OG0005990	1	1	1	1	4
OG0005991	1	1	1	1	4
OG0005992	3	1	0	0	4
OG0005993	3	1	0	0	4
OG0005994	1	1	1	1	4
OG0005995	2	1	0	1	4
OG0005996	1	1	1	1	4
OG0005997	1	1	1	1	4
OG0005998	1	1	1	1	4
OG0005999	2	1	1	0	4
OG0006000	1	1	1	1	4
OG0006001	1	1	1	1	4
OG0006002	1	1	1	1	4
OG0006003	1	1	1	1	4
OG0006004	1	1	1	1	4
OG0006005	1	2	1	0	4
OG0006006	1	1	1	1	4
OG0006007	1	1	1	1	4
OG0006008	3	0	1	0	4
OG0006009	4	0	0	0	4
OG0006010	1	1	1	1	4
OG0006011	1	1	1	1	4
OG0006012	1	1	1	1	4
OG0006013	1	1	1	1	4
OG0006014	1	1	1	1	4
OG0006015	2	1	1	0	4
OG0006016	1	1	1	1	4
OG0006017	1	1	1	1	4
OG0006018	1	1	1	1	4
OG0006019	1	1	1	1	4
OG0006020	1	1	1	1	4
OG0006021	1	1	1	1	4
OG0006022	1	1	1	1	4
OG0006023	1	1	1	1	4
OG0006024	1	1	1	1	4
OG0006025	1	1	1	1	4
OG0006026	2	0	1	1	4
OG0006027	1	1	1	1	4
OG0006028	1	1	1	1	4
OG0006029	1	1	1	1	4
OG0006030	1	1	1	1	4
OG0006031	1	1	1	1	4
OG0006032	1	1	1	1	4
OG0006033	1	1	1	1	4
OG0006034	1	1	1	1	4
OG0006035	1	1	1	1	4
OG0006036	1	1	1	1	4
OG0006037	1	1	1	1	4
OG0006038	1	1	1	1	4
OG0006039	1	1	1	1	4
OG0006040	1	1	1	1	4
OG0006041	1	1	1	1	4
OG0006042	1	1	1	1	4
OG0006043	1	1	1	1	4
OG0006044	1	1	1	1	4
OG0006045	1	1	1	1	4
OG0006046	1	1	1	1	4
OG0006047	1	1	1	1	4
OG0006048	1	1	1	1	4
OG0006049	1	1	1	1	4
OG0006050	2	1	1	0	4
OG0006051	1	1	1	1	4
OG0006052	1	1	1	1	4
OG0006053	1	1	1	1	4
OG0006054	1	1	1	1	4
OG0006055	1	1	1	1	4
OG0006056	1	1	1	1	4
OG0006057	2	1	1	0	4
OG0006058	1	1	1	1	4
OG0006059	1	1	2	0	4
OG0006060	1	1	1	1	4
OG0006061	1	1	1	1	4
OG0006062	1	1	1	1	4
OG0006063	1	1	1	1	4
OG0006064	1	1	1	1	4
OG0006065	1	1	1	1	4
OG0006066	1	1	1	1	4
OG0006067	2	1	1	0	4
OG0006068	1	1	1	1	4
OG0006069	1	1	1	1	4
OG0006070	1	1	1	1	4
OG0006071	2	1	0	1	4
OG0006072	1	1	1	1	4
OG0006073	2	1	1	0	4
OG0006074	1	1	1	1	4
OG0006075	1	1	1	1	4
OG0006076	1	1	1	1	4
OG0006077	1	1	1	1	4
OG0006078	1	1	1	1	4
OG0006079	1	1	1	1	4
OG0006080	1	1	1	1	4
OG0006081	1	1	1	1	4
OG0006082	1	1	1	1	4
OG0006083	3	1	0	0	4
OG0006084	1	1	1	1	4
OG0006085	1	1	1	1	4
OG0006086	1	1	1	1	4
OG0006087	1	1	1	1	4
OG0006088	1	1	1	1	4
OG0006089	4	0	0	0	4
OG0006090	1	1	1	1	4
OG0006091	1	1	1	1	4
OG0006092	1	1	1	1	4
OG0006093	1	1	1	1	4
OG0006094	2	1	1	0	4
OG0006095	1	1	1	1	4
OG0006096	3	0	1	0	4
OG0006097	1	1	1	1	4
OG0006098	3	0	1	0	4
OG0006099	1	1	1	1	4
OG0006100	2	1	1	0	4
OG0006101	1	1	1	1	4
OG0006102	1	1	1	1	4
OG0006103	1	1	1	1	4
OG0006104	1	2	1	0	4
OG0006105	1	1	1	1	4
OG0006106	1	1	1	1	4
OG0006107	1	1	1	1	4
OG0006108	1	1	1	1	4
OG0006109	1	1	1	1	4
OG0006110	1	1	1	1	4
OG0006111	1	1	1	1	4
OG0006112	1	1	1	1	4
OG0006113	1	1	1	1	4
OG0006114	1	1	1	1	4
OG0006115	1	1	1	1	4
OG0006116	1	1	1	1	4
OG0006117	1	1	1	1	4
OG0006118	1	1	1	1	4
OG0006119	2	2	0	0	4
OG0006120	1	2	1	0	4
OG0006121	1	1	1	1	4
OG0006122	1	1	1	1	4
OG0006123	3	1	0	0	4
OG0006124	1	1	1	1	4
OG0006125	1	1	1	1	4
OG0006126	1	1	1	1	4
OG0006127	1	1	1	1	4
OG0006128	1	1	1	1	4
OG0006129	1	1	1	1	4
OG0006130	2	1	1	0	4
OG0006131	1	1	1	1	4
OG0006132	1	1	1	1	4
OG0006133	1	1	1	1	4
OG0006134	1	1	1	1	4
OG0006135	1	1	1	1	4
OG0006136	1	1	1	1	4
OG0006137	1	1	1	1	4
OG0006138	1	1	1	1	4
OG0006139	1	1	1	1	4
OG0006140	1	1	1	1	4
OG0006141	1	1	1	1	4
OG0006142	1	1	1	1	4
OG0006143	2	1	1	0	4
OG0006144	1	1	1	1	4
OG0006145	1	1	1	1	4
OG0006146	1	1	1	1	4
OG0006147	1	1	1	1	4
OG0006148	1	1	1	1	4
OG0006149	2	1	1	0	4
OG0006150	2	1	1	0	4
OG0006151	1	1	1	1	4
OG0006152	1	1	1	1	4
OG0006153	1	1	1	1	4
OG0006154	1	1	1	1	4
OG0006155	1	1	1	1	4
OG0006156	1	1	1	1	4
OG0006157	1	1	1	1	4
OG0006158	1	1	1	1	4
OG0006159	1	1	1	1	4
OG0006160	1	1	1	1	4
OG0006161	1	1	1	1	4
OG0006162	1	1	1	1	4
OG0006163	1	1	1	1	4
OG0006164	1	0	2	1	4
OG0006165	1	1	1	1	4
OG0006166	1	1	1	1	4
OG0006167	2	1	1	0	4
OG0006168	1	1	1	1	4
OG0006169	1	1	1	1	4
OG0006170	3	1	0	0	4
OG0006171	2	1	1	0	4
OG0006172	1	1	1	1	4
OG0006173	1	1	1	1	4
OG0006174	1	1	1	1	4
OG0006175	1	1	1	1	4
OG0006176	1	1	1	1	4
OG0006177	1	1	2	0	4
OG0006178	1	1	1	1	4
OG0006179	1	1	1	1	4
OG0006180	1	1	1	1	4
OG0006181	1	1	1	1	4
OG0006182	1	1	2	0	4
OG0006183	1	1	1	1	4
OG0006184	1	1	1	1	4
OG0006185	1	1	1	1	4
OG0006186	1	1	1	1	4
OG0006187	1	1	1	1	4
OG0006188	2	1	1	0	4
OG0006189	1	1	1	1	4
OG0006190	1	1	1	1	4
OG0006191	1	1	1	1	4
OG0006192	1	1	1	1	4
OG0006193	1	1	1	1	4
OG0006194	1	1	1	1	4
OG0006195	1	1	1	1	4
OG0006196	1	1	1	1	4
OG0006197	1	1	1	1	4
OG0006198	1	1	1	1	4
OG0006199	1	2	1	0	4
OG0006200	1	1	1	1	4
OG0006201	1	1	1	1	4
OG0006202	1	1	1	1	4
OG0006203	1	1	2	0	4
OG0006204	1	1	1	1	4
OG0006205	1	1	1	1	4
OG0006206	1	1	1	1	4
OG0006207	2	1	1	0	4
OG0006208	1	1	1	1	4
OG0006209	1	1	1	1	4
OG0006210	1	1	1	1	4
OG0006211	1	1	1	1	4
OG0006212	1	1	1	1	4
OG0006213	1	1	1	1	4
OG0006214	1	1	1	1	4
OG0006215	1	1	1	1	4
OG0006216	1	1	1	1	4
OG0006217	1	1	1	1	4
OG0006218	1	1	2	0	4
OG0006219	1	1	1	1	4
OG0006220	1	1	1	1	4
OG0006221	1	1	1	1	4
OG0006222	1	1	1	1	4
OG0006223	1	1	1	1	4
OG0006224	1	1	2	0	4
OG0006225	1	1	1	1	4
OG0006226	1	1	1	1	4
OG0006227	1	1	1	1	4
OG0006228	1	1	1	1	4
OG0006229	1	1	1	1	4
OG0006230	1	1	1	1	4
OG0006231	1	1	1	1	4
OG0006232	1	1	1	1	4
OG0006233	1	1	1	1	4
OG0006234	1	1	1	1	4
OG0006235	1	1	1	1	4
OG0006236	1	1	1	1	4
OG0006237	1	1	1	1	4
OG0006238	1	1	1	1	4
OG0006239	1	1	1	1	4
OG0006240	1	1	1	1	4
OG0006241	1	1	1	1	4
OG0006242	1	1	1	1	4
OG0006243	1	1	1	1	4
OG0006244	1	1	1	1	4
OG0006245	1	1	1	1	4
OG0006246	1	1	1	1	4
OG0006247	1	1	1	1	4
OG0006248	1	1	1	1	4
OG0006249	1	1	1	1	4
OG0006250	2	1	1	0	4
OG0006251	1	1	1	1	4
OG0006252	1	1	1	1	4
OG0006253	1	1	1	1	4
OG0006254	1	1	1	1	4
OG0006255	1	3	0	0	4
OG0006256	1	1	1	1	4
OG0006257	1	1	1	1	4
OG0006258	1	1	1	1	4
OG0006259	1	1	1	1	4
OG0006260	1	2	1	0	4
OG0006261	1	1	1	1	4
OG0006262	1	1	1	1	4
OG0006263	1	1	1	1	4
OG0006264	1	1	2	0	4
OG0006265	1	1	1	1	4
OG0006266	1	1	1	1	4
OG0006267	1	1	1	1	4
OG0006268	2	1	1	0	4
OG0006269	1	1	1	1	4
OG0006270	1	1	1	1	4
OG0006271	1	1	1	1	4
OG0006272	2	1	1	0	4
OG0006273	1	1	1	1	4
OG0006274	1	1	1	1	4
OG0006275	1	1	1	1	4
OG0006276	1	1	1	1	4
OG0006277	1	1	1	1	4
OG0006278	1	1	1	1	4
OG0006279	1	1	1	1	4
OG0006280	1	1	1	1	4
OG0006281	1	1	1	1	4
OG0006282	1	1	1	1	4
OG0006283	1	1	1	1	4
OG0006284	1	1	1	1	4
OG0006285	1	1	1	1	4
OG0006286	1	1	1	1	4
OG0006287	1	1	1	1	4
OG0006288	1	1	1	1	4
OG0006289	1	1	1	1	4
OG0006290	1	1	1	1	4
OG0006291	2	1	1	0	4
OG0006292	1	1	1	1	4
OG0006293	1	1	1	1	4
OG0006294	2	1	1	0	4
OG0006295	2	1	1	0	4
OG0006296	1	1	1	1	4
OG0006297	1	1	1	1	4
OG0006298	1	1	1	1	4
OG0006299	1	1	1	1	4
OG0006300	1	1	1	1	4
OG0006301	2	1	1	0	4
OG0006302	1	1	2	0	4
OG0006303	2	1	1	0	4
OG0006304	1	1	1	1	4
OG0006305	1	1	1	1	4
OG0006306	1	1	1	1	4
OG0006307	1	1	1	1	4
OG0006308	2	1	1	0	4
OG0006309	1	1	1	1	4
OG0006310	1	1	1	1	4
OG0006311	1	1	1	1	4
OG0006312	1	2	1	0	4
OG0006313	1	1	1	1	4
OG0006314	1	1	1	1	4
OG0006315	1	1	1	1	4
OG0006316	1	1	1	1	4
OG0006317	1	1	1	1	4
OG0006318	1	1	1	1	4
OG0006319	1	1	1	1	4
OG0006320	1	1	2	0	4
OG0006321	1	1	1	1	4
OG0006322	2	1	1	0	4
OG0006323	1	1	1	1	4
OG0006324	1	1	1	1	4
OG0006325	1	1	1	1	4
OG0006326	1	1	1	1	4
OG0006327	1	1	1	1	4
OG0006328	1	1	1	1	4
OG0006329	1	1	1	1	4
OG0006330	1	1	1	1	4
OG0006331	1	1	1	1	4
OG0006332	1	1	2	0	4
OG0006333	1	1	1	1	4
OG0006334	1	1	1	1	4
OG0006335	1	1	1	1	4
OG0006336	1	1	1	1	4
OG0006337	1	1	1	1	4
OG0006338	1	1	1	1	4
OG0006339	1	1	1	1	4
OG0006340	1	1	1	1	4
OG0006341	1	1	1	1	4
OG0006342	1	1	1	1	4
OG0006343	1	1	1	1	4
OG0006344	1	1	1	1	4
OG0006345	1	0	1	2	4
OG0006346	1	1	1	1	4
OG0006347	1	1	1	1	4
OG0006348	4	0	0	0	4
OG0006349	1	1	1	1	4
OG0006350	1	1	1	1	4
OG0006351	1	1	1	1	4
OG0006352	1	1	1	1	4
OG0006353	1	1	1	1	4
OG0006354	1	1	1	1	4
OG0006355	1	1	1	1	4
OG0006356	1	1	1	1	4
OG0006357	2	1	1	0	4
OG0006358	1	1	1	1	4
OG0006359	1	1	1	1	4
OG0006360	1	1	1	1	4
OG0006361	2	1	1	0	4
OG0006362	1	1	1	1	4
OG0006363	1	1	1	1	4
OG0006364	1	1	1	1	4
OG0006365	1	1	1	1	4
OG0006366	1	1	1	1	4
OG0006367	1	1	1	1	4
OG0006368	1	1	1	1	4
OG0006369	1	1	1	1	4
OG0006370	1	1	1	1	4
OG0006371	1	1	1	1	4
OG0006372	3	1	0	0	4
OG0006373	1	1	1	1	4
OG0006374	1	1	1	1	4
OG0006375	1	1	1	1	4
OG0006376	1	1	1	1	4
OG0006377	1	1	1	1	4
OG0006378	1	1	1	1	4
OG0006379	1	1	2	0	4
OG0006380	2	1	1	0	4
OG0006381	1	1	1	1	4
OG0006382	1	1	1	1	4
OG0006383	1	1	1	1	4
OG0006384	1	1	1	1	4
OG0006385	1	1	1	1	4
OG0006386	1	1	1	1	4
OG0006387	1	1	1	1	4
OG0006388	1	1	1	1	4
OG0006389	1	1	1	1	4
OG0006390	1	1	1	1	4
OG0006391	1	1	1	1	4
OG0006392	1	1	1	1	4
OG0006393	1	1	1	1	4
OG0006394	1	1	1	1	4
OG0006395	1	1	1	1	4
OG0006396	1	1	1	1	4
OG0006397	1	2	1	0	4
OG0006398	1	1	1	1	4
OG0006399	1	1	1	1	4
OG0006400	1	1	1	1	4
OG0006401	1	1	1	1	4
OG0006402	1	1	1	1	4
OG0006403	1	1	2	0	4
OG0006404	1	1	1	1	4
OG0006405	1	1	1	1	4
OG0006406	3	1	0	0	4
OG0006407	1	1	1	1	4
OG0006408	1	2	1	0	4
OG0006409	2	1	1	0	4
OG0006410	1	1	1	1	4
OG0006411	1	1	1	1	4
OG0006412	2	1	1	0	4
OG0006413	1	1	1	1	4
OG0006414	1	1	1	1	4
OG0006415	1	1	1	1	4
OG0006416	1	1	1	1	4
OG0006417	3	0	0	1	4
OG0006418	1	1	1	1	4
OG0006419	1	1	1	1	4
OG0006420	1	1	1	1	4
OG0006421	1	1	1	1	4
OG0006422	1	2	0	1	4
OG0006423	2	1	1	0	4
OG0006424	1	1	1	1	4
OG0006425	1	1	1	1	4
OG0006426	3	0	1	0	4
OG0006427	1	1	1	1	4
OG0006428	1	1	1	1	4
OG0006429	1	1	1	1	4
OG0006430	1	1	1	1	4
OG0006431	1	1	1	1	4
OG0006432	1	1	1	1	4
OG0006433	1	1	1	1	4
OG0006434	1	1	1	1	4
OG0006435	1	1	1	1	4
OG0006436	1	1	1	1	4
OG0006437	1	1	1	1	4
OG0006438	1	1	1	1	4
OG0006439	1	1	1	1	4
OG0006440	1	1	1	1	4
OG0006441	1	1	1	1	4
OG0006442	1	1	1	1	4
OG0006443	1	1	1	1	4
OG0006444	1	1	1	1	4
OG0006445	1	1	1	1	4
OG0006446	3	1	0	0	4
OG0006447	1	1	1	1	4
OG0006448	1	3	0	0	4
OG0006449	1	1	1	1	4
OG0006450	1	1	1	1	4
OG0006451	1	1	1	1	4
OG0006452	1	1	1	1	4
OG0006453	1	1	1	1	4
OG0006454	2	1	1	0	4
OG0006455	1	1	1	1	4
OG0006456	1	1	1	1	4
OG0006457	1	1	1	1	4
OG0006458	1	1	1	1	4
OG0006459	1	1	1	1	4
OG0006460	1	1	1	1	4
OG0006461	1	1	1	1	4
OG0006462	1	1	1	1	4
OG0006463	1	1	1	1	4
OG0006464	1	1	1	1	4
OG0006465	1	1	1	1	4
OG0006466	1	1	1	1	4
OG0006467	1	1	1	1	4
OG0006468	1	1	1	1	4
OG0006469	1	1	1	1	4
OG0006470	1	1	1	1	4
OG0006471	1	1	1	1	4
OG0006472	1	1	1	1	4
OG0006473	1	1	1	1	4
OG0006474	1	1	1	1	4
OG0006475	1	1	1	1	4
OG0006476	1	1	1	1	4
OG0006477	1	1	1	1	4
OG0006478	1	3	0	0	4
OG0006479	1	1	1	1	4
OG0006480	1	1	1	1	4
OG0006481	1	1	1	1	4
OG0006482	1	1	1	1	4
OG0006483	1	1	1	1	4
OG0006484	1	1	1	1	4
OG0006485	1	1	1	1	4
OG0006486	1	1	1	1	4
OG0006487	1	1	1	1	4
OG0006488	1	0	3	0	4
OG0006489	1	0	1	2	4
OG0006490	1	1	1	1	4
OG0006491	1	1	1	1	4
OG0006492	1	1	1	1	4
OG0006493	1	1	1	1	4
OG0006494	4	0	0	0	4
OG0006495	1	1	1	1	4
OG0006496	1	1	1	1	4
OG0006497	1	1	1	1	4
OG0006498	1	1	1	1	4
OG0006499	1	1	1	1	4
OG0006500	1	1	1	1	4
OG0006501	1	1	1	1	4
OG0006502	1	1	1	1	4
OG0006503	1	1	1	1	4
OG0006504	1	1	1	1	4
OG0006505	2	1	1	0	4
OG0006506	1	1	1	1	4
OG0006507	1	1	1	1	4
OG0006508	1	1	1	1	4
OG0006509	1	1	1	1	4
OG0006510	1	1	1	1	4
OG0006511	1	1	1	1	4
OG0006512	1	1	1	1	4
OG0006513	1	1	1	1	4
OG0006514	1	1	1	1	4
OG0006515	1	1	1	1	4
OG0006516	4	0	0	0	4
OG0006517	1	1	1	1	4
OG0006518	1	1	1	1	4
OG0006519	1	1	1	1	4
OG0006520	1	1	1	1	4
OG0006521	1	1	1	1	4
OG0006522	2	1	1	0	4
OG0006523	1	1	1	1	4
OG0006524	1	1	1	1	4
OG0006525	1	1	1	1	4
OG0006526	1	1	1	1	4
OG0006527	1	1	1	1	4
OG0006528	1	1	1	1	4
OG0006529	1	1	1	1	4
OG0006530	1	1	1	1	4
OG0006531	2	1	1	0	4
OG0006532	1	1	1	1	4
OG0006533	1	1	1	1	4
OG0006534	1	1	1	1	4
OG0006535	1	1	1	1	4
OG0006536	1	1	1	1	4
OG0006537	1	1	1	1	4
OG0006538	1	1	1	1	4
OG0006539	1	1	1	1	4
OG0006540	1	1	1	1	4
OG0006541	2	1	1	0	4
OG0006542	1	1	1	1	4
OG0006543	1	1	1	1	4
OG0006544	1	1	1	1	4
OG0006545	1	1	1	1	4
OG0006546	1	1	1	1	4
OG0006547	1	1	1	1	4
OG0006548	1	1	1	1	4
OG0006549	1	1	1	1	4
OG0006550	1	1	1	1	4
OG0006551	1	1	1	1	4
OG0006552	1	1	1	1	4
OG0006553	1	1	1	1	4
OG0006554	1	1	1	1	4
OG0006555	1	1	1	1	4
OG0006556	1	1	1	1	4
OG0006557	1	1	1	1	4
OG0006558	1	1	1	1	4
OG0006559	1	1	1	1	4
OG0006560	1	1	1	1	4
OG0006561	1	1	1	1	4
OG0006562	1	1	1	1	4
OG0006563	1	1	1	1	4
OG0006564	1	1	1	1	4
OG0006565	1	1	1	1	4
OG0006566	2	1	1	0	4
OG0006567	1	1	1	1	4
OG0006568	1	1	1	1	4
OG0006569	1	1	1	1	4
OG0006570	1	1	1	1	4
OG0006571	1	1	1	1	4
OG0006572	1	1	1	1	4
OG0006573	1	1	1	1	4
OG0006574	1	1	1	1	4
OG0006575	1	1	1	1	4
OG0006576	1	1	1	1	4
OG0006577	1	1	1	1	4
OG0006578	1	1	1	1	4
OG0006579	1	1	1	1	4
OG0006580	1	1	1	1	4
OG0006581	1	1	1	1	4
OG0006582	1	1	1	1	4
OG0006583	1	1	1	1	4
OG0006584	1	1	1	1	4
OG0006585	1	1	1	1	4
OG0006586	1	1	1	1	4
OG0006587	1	1	1	1	4
OG0006588	2	1	1	0	4
OG0006589	1	1	1	1	4
OG0006590	1	1	1	1	4
OG0006591	1	1	1	1	4
OG0006592	1	1	1	1	4
OG0006593	2	0	2	0	4
OG0006594	1	1	1	1	4
OG0006595	2	1	1	0	4
OG0006596	1	2	1	0	4
OG0006597	1	1	1	1	4
OG0006598	1	1	1	1	4
OG0006599	1	1	1	1	4
OG0006600	1	1	1	1	4
OG0006601	1	1	1	1	4
OG0006602	1	1	1	1	4
OG0006603	1	1	1	1	4
OG0006604	1	1	1	1	4
OG0006605	1	1	1	1	4
OG0006606	1	1	1	1	4
OG0006607	1	1	1	1	4
OG0006608	1	1	1	1	4
OG0006609	1	1	1	1	4
OG0006610	1	1	1	1	4
OG0006611	1	1	1	1	4
OG0006612	1	1	1	1	4
OG0006613	1	1	1	1	4
OG0006614	1	1	1	1	4
OG0006615	1	1	1	1	4
OG0006616	1	1	1	1	4
OG0006617	1	1	1	1	4
OG0006618	1	1	1	1	4
OG0006619	1	1	1	1	4
OG0006620	1	1	1	1	4
OG0006621	1	1	1	1	4
OG0006622	2	1	1	0	4
OG0006623	1	1	1	1	4
OG0006624	1	1	1	1	4
OG0006625	1	1	1	1	4
OG0006626	1	1	1	1	4
OG0006627	1	1	1	1	4
OG0006628	2	1	1	0	4
OG0006629	1	1	1	1	4
OG0006630	1	1	1	1	4
OG0006631	1	1	1	1	4
OG0006632	1	1	1	1	4
OG0006633	1	1	1	1	4
OG0006634	1	1	1	1	4
OG0006635	1	1	1	1	4
OG0006636	1	1	2	0	4
OG0006637	1	1	1	1	4
OG0006638	1	1	1	1	4
OG0006639	3	0	1	0	4
OG0006640	1	1	1	1	4
OG0006641	1	1	2	0	4
OG0006642	1	1	1	1	4
OG0006643	2	1	1	0	4
OG0006644	2	1	1	0	4
OG0006645	1	1	1	1	4
OG0006646	2	1	1	0	4
OG0006647	1	1	1	1	4
OG0006648	1	1	1	1	4
OG0006649	1	1	1	1	4
OG0006650	1	1	1	1	4
OG0006651	1	1	1	1	4
OG0006652	2	1	1	0	4
OG0006653	1	1	1	1	4
OG0006654	1	2	1	0	4
OG0006655	1	1	1	1	4
OG0006656	1	1	1	1	4
OG0006657	1	1	1	1	4
OG0006658	1	1	1	1	4
OG0006659	1	1	1	1	4
OG0006660	1	1	1	1	4
OG0006661	1	1	1	1	4
OG0006662	1	1	1	1	4
OG0006663	1	1	1	1	4
OG0006664	1	1	1	1	4
OG0006665	2	1	1	0	4
OG0006666	1	1	1	1	4
OG0006667	1	1	1	1	4
OG0006668	1	1	1	1	4
OG0006669	1	1	1	1	4
OG0006670	1	1	1	1	4
OG0006671	1	1	1	1	4
OG0006672	1	1	1	1	4
OG0006673	1	1	1	1	4
OG0006674	1	1	1	1	4
OG0006675	1	1	1	1	4
OG0006676	2	1	1	0	4
OG0006677	2	1	1	0	4
OG0006678	1	1	1	1	4
OG0006679	2	1	1	0	4
OG0006680	1	1	1	1	4
OG0006681	1	1	1	1	4
OG0006682	1	1	1	1	4
OG0006683	1	1	1	1	4
OG0006684	1	1	1	1	4
OG0006685	1	1	1	1	4
OG0006686	1	1	1	1	4
OG0006687	1	1	1	1	4
OG0006688	1	1	1	1	4
OG0006689	1	1	1	1	4
OG0006690	1	1	1	1	4
OG0006691	1	1	1	1	4
OG0006692	1	1	1	1	4
OG0006693	3	1	0	0	4
OG0006694	1	1	1	1	4
OG0006695	1	1	1	1	4
OG0006696	1	1	1	1	4
OG0006697	1	1	1	1	4
OG0006698	2	1	1	0	4
OG0006699	1	1	1	1	4
OG0006700	1	1	1	1	4
OG0006701	1	1	1	1	4
OG0006702	1	1	1	1	4
OG0006703	1	1	1	1	4
OG0006704	1	1	1	1	4
OG0006705	1	3	0	0	4
OG0006706	1	1	1	1	4
OG0006707	1	1	1	1	4
OG0006708	1	1	1	1	4
OG0006709	1	1	1	1	4
OG0006710	1	1	1	1	4
OG0006711	1	1	1	1	4
OG0006712	1	1	1	1	4
OG0006713	1	1	1	1	4
OG0006714	1	1	1	1	4
OG0006715	3	1	0	0	4
OG0006716	1	1	1	1	4
OG0006717	1	1	1	1	4
OG0006718	1	1	1	1	4
OG0006719	1	1	1	1	4
OG0006720	1	1	1	1	4
OG0006721	1	1	1	1	4
OG0006722	1	1	2	0	4
OG0006723	1	1	1	1	4
OG0006724	1	1	1	1	4
OG0006725	1	1	1	1	4
OG0006726	1	1	1	1	4
OG0006727	1	1	1	1	4
OG0006728	1	1	1	1	4
OG0006729	3	0	1	0	4
OG0006730	1	1	1	1	4
OG0006731	1	1	1	1	4
OG0006732	1	1	1	1	4
OG0006733	1	1	1	1	4
OG0006734	2	1	1	0	4
OG0006735	1	1	1	1	4
OG0006736	1	1	1	1	4
OG0006737	1	1	1	1	4
OG0006738	2	1	1	0	4
OG0006739	1	1	1	1	4
OG0006740	1	1	1	1	4
OG0006741	1	1	1	1	4
OG0006742	1	1	1	1	4
OG0006743	1	1	1	1	4
OG0006744	1	1	1	1	4
OG0006745	1	1	1	1	4
OG0006746	1	1	1	1	4
OG0006747	1	1	1	1	4
OG0006748	1	1	1	1	4
OG0006749	2	1	1	0	4
OG0006750	1	1	1	1	4
OG0006751	1	1	1	1	4
OG0006752	1	1	1	1	4
OG0006753	1	1	1	1	4
OG0006754	1	1	1	1	4
OG0006755	1	1	1	1	4
OG0006756	1	1	1	1	4
OG0006757	1	1	1	1	4
OG0006758	1	1	1	1	4
OG0006759	1	1	1	1	4
OG0006760	1	1	1	1	4
OG0006761	1	1	1	1	4
OG0006762	1	1	1	1	4
OG0006763	1	1	1	1	4
OG0006764	1	1	1	1	4
OG0006765	1	1	1	1	4
OG0006766	1	1	1	1	4
OG0006767	1	1	1	1	4
OG0006768	1	1	1	1	4
OG0006769	1	1	1	1	4
OG0006770	1	1	1	1	4
OG0006771	1	1	1	1	4
OG0006772	1	1	2	0	4
OG0006773	1	1	1	1	4
OG0006774	1	1	1	1	4
OG0006775	1	1	1	1	4
OG0006776	1	1	1	1	4
OG0006777	2	1	0	1	4
OG0006778	1	1	1	1	4
OG0006779	1	1	1	1	4
OG0006780	1	1	1	1	4
OG0006781	1	1	1	1	4
OG0006782	1	1	1	1	4
OG0006783	1	1	1	1	4
OG0006784	2	1	1	0	4
OG0006785	1	1	1	1	4
OG0006786	1	1	1	1	4
OG0006787	1	1	1	1	4
OG0006788	2	1	1	0	4
OG0006789	1	1	1	1	4
OG0006790	1	1	1	1	4
OG0006791	1	1	1	1	4
OG0006792	1	1	1	1	4
OG0006793	1	1	1	1	4
OG0006794	1	1	1	1	4
OG0006795	1	1	1	1	4
OG0006796	1	1	1	1	4
OG0006797	1	1	1	1	4
OG0006798	1	1	1	1	4
OG0006799	1	1	1	1	4
OG0006800	1	1	1	1	4
OG0006801	1	1	1	1	4
OG0006802	2	1	1	0	4
OG0006803	4	0	0	0	4
OG0006804	1	1	1	1	4
OG0006805	1	1	1	1	4
OG0006806	1	1	1	1	4
OG0006807	1	1	1	1	4
OG0006808	1	1	1	1	4
OG0006809	1	1	1	1	4
OG0006810	1	1	1	1	4
OG0006811	1	1	1	1	4
OG0006812	1	1	1	1	4
OG0006813	1	1	1	1	4
OG0006814	1	1	1	1	4
OG0006815	1	1	1	1	4
OG0006816	1	1	1	1	4
OG0006817	3	0	1	0	4
OG0006818	1	1	1	1	4
OG0006819	1	0	3	0	4
OG0006820	1	1	1	1	4
OG0006821	1	1	1	1	4
OG0006822	1	1	1	1	4
OG0006823	1	1	1	1	4
OG0006824	1	1	1	1	4
OG0006825	2	1	1	0	4
OG0006826	1	1	1	1	4
OG0006827	1	1	1	1	4
OG0006828	1	1	1	1	4
OG0006829	1	1	1	1	4
OG0006830	1	1	1	1	4
OG0006831	1	1	1	1	4
OG0006832	1	1	1	1	4
OG0006833	2	1	1	0	4
OG0006834	1	1	1	1	4
OG0006835	1	1	2	0	4
OG0006836	1	1	1	1	4
OG0006837	1	1	1	1	4
OG0006838	1	1	1	1	4
OG0006839	2	1	1	0	4
OG0006840	1	1	1	1	4
OG0006841	1	1	1	1	4
OG0006842	1	1	1	1	4
OG0006843	1	1	1	1	4
OG0006844	1	1	1	1	4
OG0006845	1	1	1	1	4
OG0006846	1	1	1	1	4
OG0006847	2	1	1	0	4
OG0006848	1	1	1	1	4
OG0006849	1	1	1	1	4
OG0006850	1	1	1	1	4
OG0006851	1	1	1	1	4
OG0006852	1	1	1	1	4
OG0006853	1	1	1	1	4
OG0006854	1	0	3	0	4
OG0006855	1	1	1	1	4
OG0006856	1	1	1	1	4
OG0006857	1	1	1	1	4
OG0006858	1	1	1	1	4
OG0006859	1	1	1	1	4
OG0006860	1	1	1	1	4
OG0006861	1	1	1	1	4
OG0006862	1	1	1	1	4
OG0006863	1	1	1	1	4
OG0006864	1	1	1	1	4
OG0006865	1	1	1	1	4
OG0006866	1	1	1	1	4
OG0006867	1	1	1	1	4
OG0006868	1	1	1	1	4
OG0006869	1	1	1	1	4
OG0006870	1	1	1	1	4
OG0006871	1	1	1	1	4
OG0006872	3	0	1	0	4
OG0006873	1	1	1	1	4
OG0006874	2	1	1	0	4
OG0006875	1	1	1	1	4
OG0006876	1	1	1	1	4
OG0006877	1	1	1	1	4
OG0006878	2	1	1	0	4
OG0006879	2	1	1	0	4
OG0006880	1	1	1	1	4
OG0006881	2	1	1	0	4
OG0006882	1	1	2	0	4
OG0006883	1	1	1	1	4
OG0006884	1	1	1	1	4
OG0006885	1	1	1	1	4
OG0006886	1	1	1	1	4
OG0006887	1	1	1	1	4
OG0006888	1	1	1	1	4
OG0006889	1	1	1	1	4
OG0006890	1	1	1	1	4
OG0006891	1	1	1	1	4
OG0006892	1	1	1	1	4
OG0006893	1	1	1	1	4
OG0006894	1	1	1	1	4
OG0006895	1	1	1	1	4
OG0006896	1	1	1	1	4
OG0006897	1	1	1	1	4
OG0006898	1	1	1	1	4
OG0006899	1	1	1	1	4
OG0006900	1	1	1	1	4
OG0006901	1	1	1	1	4
OG0006902	1	1	1	1	4
OG0006903	1	1	1	1	4
OG0006904	1	1	2	0	4
OG0006905	1	1	1	1	4
OG0006906	1	1	1	1	4
OG0006907	2	1	1	0	4
OG0006908	1	2	0	1	4
OG0006909	1	1	1	1	4
OG0006910	1	1	1	1	4
OG0006911	1	1	1	1	4
OG0006912	1	1	1	1	4
OG0006913	1	1	1	1	4
OG0006914	1	1	1	1	4
OG0006915	1	1	1	1	4
OG0006916	1	1	1	1	4
OG0006917	1	1	1	1	4
OG0006918	1	1	1	1	4
OG0006919	1	1	1	1	4
OG0006920	1	1	1	1	4
OG0006921	1	1	1	1	4
OG0006922	1	1	1	1	4
OG0006923	2	1	1	0	4
OG0006924	1	1	1	1	4
OG0006925	1	1	1	1	4
OG0006926	1	1	1	1	4
OG0006927	1	1	1	1	4
OG0006928	1	1	1	1	4
OG0006929	1	1	1	1	4
OG0006930	1	1	1	1	4
OG0006931	1	1	1	1	4
OG0006932	1	1	1	1	4
OG0006933	1	1	1	1	4
OG0006934	1	1	1	1	4
OG0006935	1	1	1	1	4
OG0006936	1	1	1	1	4
OG0006937	1	1	1	1	4
OG0006938	1	1	1	1	4
OG0006939	1	1	1	1	4
OG0006940	1	1	1	1	4
OG0006941	1	1	0	2	4
OG0006942	1	1	1	1	4
OG0006943	1	1	1	1	4
OG0006944	1	2	1	0	4
OG0006945	1	1	1	1	4
OG0006946	1	1	1	1	4
OG0006947	1	1	1	1	4
OG0006948	1	1	1	1	4
OG0006949	1	1	1	1	4
OG0006950	1	1	1	1	4
OG0006951	1	1	2	0	4
OG0006952	1	1	1	1	4
OG0006953	1	1	1	1	4
OG0006954	1	1	1	1	4
OG0006955	1	1	1	1	4
OG0006956	1	1	1	1	4
OG0006957	1	1	1	1	4
OG0006958	1	1	1	1	4
OG0006959	1	1	1	1	4
OG0006960	1	1	1	1	4
OG0006961	1	1	1	1	4
OG0006962	1	1	1	1	4
OG0006963	1	1	1	1	4
OG0006964	1	1	1	1	4
OG0006965	1	1	1	1	4
OG0006966	1	1	1	1	4
OG0006967	1	1	1	1	4
OG0006968	1	1	1	1	4
OG0006969	1	1	1	1	4
OG0006970	1	1	1	1	4
OG0006971	1	1	1	1	4
OG0006972	1	1	1	1	4
OG0006973	1	1	1	1	4
OG0006974	1	1	1	1	4
OG0006975	1	1	1	1	4
OG0006976	1	1	1	1	4
OG0006977	1	1	1	1	4
OG0006978	1	1	1	1	4
OG0006979	1	1	1	1	4
OG0006980	1	1	1	1	4
OG0006981	1	1	1	1	4
OG0006982	1	1	1	1	4
OG0006983	1	1	1	1	4
OG0006984	1	1	1	1	4
OG0006985	1	1	1	1	4
OG0006986	1	1	1	1	4
OG0006987	1	1	1	1	4
OG0006988	1	1	1	1	4
OG0006989	1	1	1	1	4
OG0006990	2	1	1	0	4
OG0006991	2	1	0	1	4
OG0006992	1	1	1	1	4
OG0006993	1	1	1	1	4
OG0006994	1	1	1	1	4
OG0006995	1	1	1	1	4
OG0006996	1	1	1	1	4
OG0006997	1	1	1	1	4
OG0006998	1	1	1	1	4
OG0006999	1	1	1	1	4
OG0007000	1	1	1	1	4
OG0007001	1	1	1	1	4
OG0007002	1	1	1	1	4
OG0007003	1	1	1	1	4
OG0007004	1	1	1	1	4
OG0007005	1	1	1	1	4
OG0007006	2	1	1	0	4
OG0007007	1	1	1	1	4
OG0007008	1	1	1	1	4
OG0007009	1	1	1	1	4
OG0007010	1	1	1	1	4
OG0007011	1	1	1	1	4
OG0007012	1	1	1	1	4
OG0007013	1	1	1	1	4
OG0007014	1	1	1	1	4
OG0007015	1	2	1	0	4
OG0007016	1	1	1	1	4
OG0007017	1	1	1	1	4
OG0007018	1	1	1	1	4
OG0007019	1	1	1	1	4
OG0007020	1	1	2	0	4
OG0007021	1	1	1	1	4
OG0007022	1	1	1	1	4
OG0007023	1	1	1	1	4
OG0007024	1	1	1	1	4
OG0007025	1	1	1	1	4
OG0007026	1	1	1	1	4
OG0007027	1	1	1	1	4
OG0007028	1	1	1	1	4
OG0007029	1	1	1	1	4
OG0007030	1	1	1	1	4
OG0007031	1	1	1	1	4
OG0007032	1	1	1	1	4
OG0007033	1	1	1	1	4
OG0007034	1	1	1	1	4
OG0007035	1	1	1	1	4
OG0007036	1	1	1	1	4
OG0007037	1	1	1	1	4
OG0007038	1	1	1	1	4
OG0007039	1	1	1	1	4
OG0007040	1	1	1	1	4
OG0007041	1	1	1	1	4
OG0007042	2	1	1	0	4
OG0007043	1	1	2	0	4
OG0007044	1	1	2	0	4
OG0007045	1	1	1	1	4
OG0007046	1	1	1	1	4
OG0007047	1	1	1	1	4
OG0007048	1	1	1	1	4
OG0007049	1	1	1	1	4
OG0007050	1	1	1	1	4
OG0007051	1	1	1	1	4
OG0007052	1	1	1	1	4
OG0007053	1	1	1	1	4
OG0007054	1	1	1	1	4
OG0007055	1	1	1	1	4
OG0007056	1	1	1	1	4
OG0007057	1	1	1	1	4
OG0007058	1	1	1	1	4
OG0007059	1	1	1	1	4
OG0007060	1	1	1	1	4
OG0007061	1	1	1	1	4
OG0007062	1	1	1	1	4
OG0007063	1	1	1	1	4
OG0007064	1	1	1	1	4
OG0007065	1	1	1	1	4
OG0007066	1	1	1	1	4
OG0007067	1	1	1	1	4
OG0007068	1	1	1	1	4
OG0007069	1	1	1	1	4
OG0007070	1	1	1	1	4
OG0007071	1	1	1	1	4
OG0007072	1	1	1	1	4
OG0007073	1	1	1	1	4
OG0007074	1	1	1	1	4
OG0007075	1	1	1	1	4
OG0007076	1	1	1	1	4
OG0007077	1	1	1	1	4
OG0007078	1	1	1	1	4
OG0007079	1	1	1	1	4
OG0007080	1	1	1	1	4
OG0007081	1	1	1	1	4
OG0007082	1	1	1	1	4
OG0007083	1	1	1	1	4
OG0007084	2	1	1	0	4
OG0007085	1	1	1	1	4
OG0007086	1	1	1	1	4
OG0007087	1	1	1	1	4
OG0007088	1	1	1	1	4
OG0007089	1	1	1	1	4
OG0007090	1	1	1	1	4
OG0007091	1	1	1	1	4
OG0007092	1	1	1	1	4
OG0007093	1	1	1	1	4
OG0007094	1	1	1	1	4
OG0007095	1	1	1	1	4
OG0007096	1	1	1	1	4
OG0007097	1	1	1	1	4
OG0007098	1	1	1	1	4
OG0007099	1	1	1	1	4
OG0007100	1	1	1	1	4
OG0007101	1	1	1	1	4
OG0007102	1	1	1	1	4
OG0007103	1	1	1	1	4
OG0007104	1	1	1	1	4
OG0007105	1	1	1	1	4
OG0007106	1	1	1	1	4
OG0007107	1	1	1	1	4
OG0007108	1	1	1	1	4
OG0007109	1	1	1	1	4
OG0007110	1	1	1	1	4
OG0007111	1	1	1	1	4
OG0007112	1	1	1	1	4
OG0007113	2	1	1	0	4
OG0007114	1	1	1	1	4
OG0007115	1	1	1	1	4
OG0007116	1	1	1	1	4
OG0007117	1	1	1	1	4
OG0007118	1	1	1	1	4
OG0007119	1	1	1	1	4
OG0007120	1	1	1	1	4
OG0007121	1	1	1	1	4
OG0007122	1	1	1	1	4
OG0007123	2	1	1	0	4
OG0007124	1	1	1	1	4
OG0007125	1	1	1	1	4
OG0007126	1	1	1	1	4
OG0007127	1	1	1	1	4
OG0007128	1	1	1	1	4
OG0007129	1	1	1	1	4
OG0007130	1	1	1	1	4
OG0007131	1	1	1	1	4
OG0007132	1	1	1	1	4
OG0007133	2	1	1	0	4
OG0007134	2	1	1	0	4
OG0007135	1	1	1	1	4
OG0007136	1	1	1	1	4
OG0007137	1	1	1	1	4
OG0007138	2	1	1	0	4
OG0007139	1	1	1	1	4
OG0007140	1	1	1	1	4
OG0007141	1	1	1	1	4
OG0007142	1	1	1	1	4
OG0007143	1	1	1	1	4
OG0007144	1	3	0	0	4
OG0007145	1	1	1	1	4
OG0007146	3	0	1	0	4
OG0007147	1	1	1	1	4
OG0007148	1	1	1	1	4
OG0007149	1	1	1	1	4
OG0007150	1	1	1	1	4
OG0007151	1	1	1	1	4
OG0007152	1	1	1	1	4
OG0007153	1	1	1	1	4
OG0007154	1	1	1	1	4
OG0007155	1	1	1	1	4
OG0007156	1	1	1	1	4
OG0007157	1	1	1	1	4
OG0007158	1	1	1	1	4
OG0007159	1	1	1	1	4
OG0007160	1	1	1	1	4
OG0007161	1	1	2	0	4
OG0007162	1	1	1	1	4
OG0007163	1	1	1	1	4
OG0007164	2	1	1	0	4
OG0007165	1	1	1	1	4
OG0007166	1	1	1	1	4
OG0007167	1	1	1	1	4
OG0007168	1	1	1	1	4
OG0007169	1	1	1	1	4
OG0007170	1	1	1	1	4
OG0007171	1	1	1	1	4
OG0007172	2	1	1	0	4
OG0007173	1	1	1	1	4
OG0007174	1	1	1	1	4
OG0007175	1	1	1	1	4
OG0007176	1	1	1	1	4
OG0007177	1	1	1	1	4
OG0007178	1	1	1	1	4
OG0007179	1	1	1	1	4
OG0007180	1	1	1	1	4
OG0007181	1	1	1	1	4
OG0007182	1	1	1	1	4
OG0007183	1	1	1	1	4
OG0007184	3	0	1	0	4
OG0007185	1	1	1	1	4
OG0007186	1	1	1	1	4
OG0007187	1	1	1	1	4
OG0007188	1	1	1	1	4
OG0007189	1	1	1	1	4
OG0007190	1	1	1	1	4
OG0007191	1	1	1	1	4
OG0007192	1	1	1	1	4
OG0007193	1	1	1	1	4
OG0007194	1	1	1	1	4
OG0007195	1	1	1	1	4
OG0007196	1	1	1	1	4
OG0007197	1	1	1	1	4
OG0007198	1	1	1	1	4
OG0007199	1	1	1	1	4
OG0007200	1	1	1	1	4
OG0007201	1	1	1	1	4
OG0007202	1	1	1	1	4
OG0007203	1	1	1	1	4
OG0007204	2	1	1	0	4
OG0007205	1	1	1	1	4
OG0007206	1	1	1	1	4
OG0007207	2	1	1	0	4
OG0007208	1	1	1	1	4
OG0007209	1	1	1	1	4
OG0007210	1	1	1	1	4
OG0007211	1	1	1	1	4
OG0007212	1	1	1	1	4
OG0007213	1	1	1	1	4
OG0007214	1	1	1	1	4
OG0007215	1	1	1	1	4
OG0007216	1	1	1	1	4
OG0007217	1	1	1	1	4
OG0007218	1	1	1	1	4
OG0007219	1	1	1	1	4
OG0007220	1	1	1	1	4
OG0007221	1	1	1	1	4
OG0007222	2	1	1	0	4
OG0007223	1	1	1	1	4
OG0007224	1	1	1	1	4
OG0007225	1	1	1	1	4
OG0007226	1	1	1	1	4
OG0007227	1	1	1	1	4
OG0007228	1	1	1	1	4
OG0007229	1	1	1	1	4
OG0007230	1	1	1	1	4
OG0007231	1	1	1	1	4
OG0007232	1	1	1	1	4
OG0007233	1	1	1	1	4
OG0007234	2	1	0	1	4
OG0007235	1	1	1	1	4
OG0007236	1	1	1	1	4
OG0007237	1	1	1	1	4
OG0007238	1	1	1	1	4
OG0007239	1	1	1	1	4
OG0007240	1	1	1	1	4
OG0007241	1	1	1	1	4
OG0007242	1	1	1	1	4
OG0007243	1	1	1	1	4
OG0007244	1	1	1	1	4
OG0007245	1	1	1	1	4
OG0007246	1	1	1	1	4
OG0007247	1	1	1	1	4
OG0007248	1	1	1	1	4
OG0007249	1	1	1	1	4
OG0007250	1	1	1	1	4
OG0007251	1	1	1	1	4
OG0007252	1	1	1	1	4
OG0007253	1	1	1	1	4
OG0007254	1	1	1	1	4
OG0007255	1	1	1	1	4
OG0007256	1	1	1	1	4
OG0007257	1	1	1	1	4
OG0007258	1	1	1	1	4
OG0007259	1	1	1	1	4
OG0007260	1	1	1	1	4
OG0007261	1	1	1	1	4
OG0007262	1	1	1	1	4
OG0007263	1	1	1	1	4
OG0007264	1	1	1	1	4
OG0007265	1	1	1	1	4
OG0007266	1	1	1	1	4
OG0007267	1	1	1	1	4
OG0007268	1	1	1	1	4
OG0007269	1	1	1	1	4
OG0007270	1	1	1	1	4
OG0007271	1	1	1	1	4
OG0007272	1	1	1	1	4
OG0007273	1	1	1	1	4
OG0007274	1	1	1	1	4
OG0007275	1	1	1	1	4
OG0007276	1	1	1	1	4
OG0007277	1	1	2	0	4
OG0007278	1	1	1	1	4
OG0007279	2	1	1	0	4
OG0007280	1	1	1	1	4
OG0007281	1	1	1	1	4
OG0007282	1	1	1	1	4
OG0007283	1	1	1	1	4
OG0007284	1	1	1	1	4
OG0007285	1	1	1	1	4
OG0007286	1	1	1	1	4
OG0007287	1	1	1	1	4
OG0007288	1	1	1	1	4
OG0007289	2	1	1	0	4
OG0007290	1	1	1	1	4
OG0007291	1	1	1	1	4
OG0007292	1	1	1	1	4
OG0007293	1	1	1	1	4
OG0007294	1	1	1	1	4
OG0007295	1	1	1	1	4
OG0007296	1	1	1	1	4
OG0007297	2	1	1	0	4
OG0007298	1	1	1	1	4
OG0007299	1	1	1	1	4
OG0007300	1	1	1	1	4
OG0007301	1	1	1	1	4
OG0007302	2	1	1	0	4
OG0007303	1	1	1	1	4
OG0007304	1	1	1	1	4
OG0007305	1	1	1	1	4
OG0007306	1	1	1	1	4
OG0007307	1	1	1	1	4
OG0007308	1	2	1	0	4
OG0007309	1	1	1	1	4
OG0007310	1	1	1	1	4
OG0007311	1	1	1	1	4
OG0007312	1	1	1	1	4
OG0007313	1	1	1	1	4
OG0007314	1	1	1	1	4
OG0007315	1	1	1	1	4
OG0007316	1	1	1	1	4
OG0007317	2	1	1	0	4
OG0007318	1	1	1	1	4
OG0007319	1	1	1	1	4
OG0007320	1	1	1	1	4
OG0007321	2	1	1	0	4
OG0007322	1	1	1	1	4
OG0007323	1	1	1	1	4
OG0007324	1	1	1	1	4
OG0007325	1	1	1	1	4
OG0007326	1	1	1	1	4
OG0007327	1	1	1	1	4
OG0007328	1	1	1	1	4
OG0007329	1	1	1	1	4
OG0007330	1	1	2	0	4
OG0007331	1	1	1	1	4
OG0007332	1	1	1	1	4
OG0007333	1	1	1	1	4
OG0007334	1	1	1	1	4
OG0007335	1	1	1	1	4
OG0007336	2	2	0	0	4
OG0007337	1	1	1	1	4
OG0007338	1	1	1	1	4
OG0007339	1	1	1	1	4
OG0007340	1	1	1	1	4
OG0007341	1	1	1	1	4
OG0007342	1	1	1	1	4
OG0007343	1	1	1	1	4
OG0007344	1	1	1	1	4
OG0007345	1	1	1	1	4
OG0007346	1	1	1	1	4
OG0007347	1	1	1	1	4
OG0007348	1	1	2	0	4
OG0007349	1	1	1	1	4
OG0007350	3	1	0	0	4
OG0007351	1	1	1	1	4
OG0007352	1	1	1	1	4
OG0007353	1	1	1	1	4
OG0007354	1	1	1	1	4
OG0007355	1	1	1	1	4
OG0007356	3	1	0	0	4
OG0007357	1	1	1	1	4
OG0007358	1	1	1	1	4
OG0007359	1	1	1	1	4
OG0007360	1	2	1	0	4
OG0007361	1	1	1	1	4
OG0007362	1	1	1	1	4
OG0007363	1	1	1	1	4
OG0007364	1	1	1	1	4
OG0007365	1	1	1	1	4
OG0007366	1	1	1	1	4
OG0007367	1	1	1	1	4
OG0007368	1	1	1	1	4
OG0007369	1	1	1	1	4
OG0007370	3	0	0	1	4
OG0007371	1	1	1	1	4
OG0007372	2	1	1	0	4
OG0007373	1	1	1	1	4
OG0007374	1	1	1	1	4
OG0007375	1	1	1	1	4
OG0007376	1	1	1	1	4
OG0007377	1	1	1	1	4
OG0007378	1	1	1	1	4
OG0007379	1	1	1	1	4
OG0007380	1	1	1	1	4
OG0007381	1	1	1	1	4
OG0007382	1	1	1	1	4
OG0007383	1	1	1	1	4
OG0007384	1	1	1	1	4
OG0007385	1	1	1	1	4
OG0007386	1	1	1	1	4
OG0007387	1	1	1	1	4
OG0007388	1	1	1	1	4
OG0007389	1	1	1	1	4
OG0007390	1	1	1	1	4
OG0007391	1	1	1	1	4
OG0007392	1	1	1	1	4
OG0007393	1	1	1	1	4
OG0007394	2	0	1	1	4
OG0007395	2	1	1	0	4
OG0007396	1	1	1	1	4
OG0007397	1	1	1	1	4
OG0007398	1	1	1	1	4
OG0007399	1	1	1	1	4
OG0007400	1	1	1	1	4
OG0007401	1	1	1	1	4
OG0007402	1	1	1	1	4
OG0007403	1	1	1	1	4
OG0007404	1	1	1	1	4
OG0007405	2	1	1	0	4
OG0007406	1	2	1	0	4
OG0007407	1	1	1	1	4
OG0007408	1	1	1	1	4
OG0007409	1	1	1	1	4
OG0007410	1	1	1	1	4
OG0007411	1	1	1	1	4
OG0007412	1	1	1	1	4
OG0007413	1	1	1	1	4
OG0007414	1	1	1	1	4
OG0007415	1	1	1	1	4
OG0007416	4	0	0	0	4
OG0007417	1	1	1	1	4
OG0007418	2	1	1	0	4
OG0007419	4	0	0	0	4
OG0007420	1	1	1	1	4
OG0007421	1	1	1	1	4
OG0007422	1	1	1	1	4
OG0007423	1	1	1	1	4
OG0007424	1	1	1	1	4
OG0007425	1	1	1	1	4
OG0007426	1	1	1	1	4
OG0007427	1	1	1	1	4
OG0007428	1	1	1	1	4
OG0007429	1	1	1	1	4
OG0007430	1	1	1	1	4
OG0007431	1	1	1	1	4
OG0007432	1	1	1	1	4
OG0007433	1	1	1	1	4
OG0007434	1	1	1	1	4
OG0007435	2	1	1	0	4
OG0007436	1	1	1	1	4
OG0007437	1	1	1	1	4
OG0007438	1	1	1	1	4
OG0007439	1	1	1	1	4
OG0007440	2	1	1	0	4
OG0007441	1	1	1	1	4
OG0007442	1	1	1	1	4
OG0007443	1	1	1	1	4
OG0007444	1	1	1	1	4
OG0007445	1	1	1	1	4
OG0007446	1	1	1	1	4
OG0007447	1	1	1	1	4
OG0007448	1	1	1	1	4
OG0007449	1	1	1	1	4
OG0007450	1	1	1	1	4
OG0007451	1	1	1	1	4
OG0007452	1	1	1	1	4
OG0007453	1	1	1	1	4
OG0007454	1	3	0	0	4
OG0007455	1	1	1	1	4
OG0007456	1	1	1	1	4
OG0007457	1	1	1	1	4
OG0007458	1	1	1	1	4
OG0007459	1	1	1	1	4
OG0007460	1	1	1	1	4
OG0007461	1	1	1	1	4
OG0007462	1	1	1	1	4
OG0007463	1	1	1	1	4
OG0007464	1	1	1	1	4
OG0007465	1	1	2	0	4
OG0007466	1	1	1	1	4
OG0007467	1	1	1	1	4
OG0007468	1	1	1	1	4
OG0007469	1	1	1	1	4
OG0007470	2	1	1	0	4
OG0007471	1	1	1	1	4
OG0007472	1	1	1	1	4
OG0007473	1	2	1	0	4
OG0007474	1	1	1	1	4
OG0007475	1	1	1	1	4
OG0007476	1	1	1	1	4
OG0007477	1	1	1	1	4
OG0007478	2	1	1	0	4
OG0007479	1	1	1	1	4
OG0007480	1	1	1	1	4
OG0007481	1	1	1	1	4
OG0007482	1	1	1	1	4
OG0007483	1	1	1	1	4
OG0007484	1	1	1	1	4
OG0007485	1	1	1	1	4
OG0007486	1	1	1	1	4
OG0007487	1	1	1	1	4
OG0007488	1	1	1	1	4
OG0007489	1	1	1	1	4
OG0007490	1	1	1	1	4
OG0007491	1	1	1	1	4
OG0007492	1	1	1	1	4
OG0007493	1	1	1	1	4
OG0007494	1	1	1	1	4
OG0007495	1	1	1	1	4
OG0007496	1	1	1	1	4
OG0007497	1	1	1	1	4
OG0007498	1	1	1	1	4
OG0007499	1	1	1	1	4
OG0007500	1	1	1	1	4
OG0007501	1	1	1	1	4
OG0007502	1	1	1	1	4
OG0007503	1	1	1	1	4
OG0007504	1	1	1	1	4
OG0007505	1	1	1	1	4
OG0007506	1	1	1	1	4
OG0007507	1	1	1	1	4
OG0007508	1	1	1	1	4
OG0007509	1	1	1	1	4
OG0007510	1	1	1	1	4
OG0007511	1	1	1	1	4
OG0007512	1	1	1	1	4
OG0007513	1	1	1	1	4
OG0007514	1	1	1	1	4
OG0007515	2	1	1	0	4
OG0007516	1	1	1	1	4
OG0007517	1	1	1	1	4
OG0007518	1	1	1	1	4
OG0007519	1	1	1	1	4
OG0007520	1	1	1	1	4
OG0007521	1	1	1	1	4
OG0007522	1	1	1	1	4
OG0007523	1	1	1	1	4
OG0007524	1	1	1	1	4
OG0007525	1	1	1	1	4
OG0007526	1	1	1	1	4
OG0007527	1	1	1	1	4
OG0007528	1	1	1	1	4
OG0007529	1	1	1	1	4
OG0007530	1	1	1	1	4
OG0007531	1	1	1	1	4
OG0007532	1	1	1	1	4
OG0007533	1	1	1	1	4
OG0007534	1	1	1	1	4
OG0007535	1	1	1	1	4
OG0007536	1	1	1	1	4
OG0007537	1	1	1	1	4
OG0007538	1	1	1	1	4
OG0007539	1	1	1	1	4
OG0007540	1	1	1	1	4
OG0007541	1	1	1	1	4
OG0007542	1	1	1	1	4
OG0007543	1	1	1	1	4
OG0007544	1	1	1	1	4
OG0007545	1	1	1	1	4
OG0007546	4	0	0	0	4
OG0007547	1	1	1	1	4
OG0007548	1	1	1	1	4
OG0007549	1	1	1	1	4
OG0007550	1	1	1	1	4
OG0007551	1	1	1	1	4
OG0007552	1	1	1	1	4
OG0007553	1	1	1	1	4
OG0007554	1	1	1	1	4
OG0007555	1	1	1	1	4
OG0007556	2	1	1	0	4
OG0007557	1	1	1	1	4
OG0007558	3	1	0	0	4
OG0007559	1	1	1	1	4
OG0007560	1	1	1	1	4
OG0007561	1	1	1	1	4
OG0007562	1	1	1	1	4
OG0007563	1	1	1	1	4
OG0007564	1	1	1	1	4
OG0007565	1	1	1	1	4
OG0007566	1	1	1	1	4
OG0007567	1	1	1	1	4
OG0007568	1	1	1	1	4
OG0007569	1	1	1	1	4
OG0007570	1	1	1	1	4
OG0007571	1	1	1	1	4
OG0007572	1	1	1	1	4
OG0007573	1	1	1	1	4
OG0007574	1	1	1	1	4
OG0007575	1	1	1	1	4
OG0007576	1	1	1	1	4
OG0007577	1	1	1	1	4
OG0007578	1	0	1	2	4
OG0007579	1	1	1	1	4
OG0007580	1	1	1	1	4
OG0007581	1	1	1	1	4
OG0007582	1	1	1	1	4
OG0007583	1	1	1	1	4
OG0007584	1	1	1	1	4
OG0007585	1	1	1	1	4
OG0007586	2	1	1	0	4
OG0007587	1	1	1	1	4
OG0007588	3	0	1	0	4
OG0007589	2	1	1	0	4
OG0007590	1	1	1	1	4
OG0007591	1	1	1	1	4
OG0007592	1	1	1	1	4
OG0007593	1	1	1	1	4
OG0007594	1	1	1	1	4
OG0007595	1	1	1	1	4
OG0007596	1	1	1	1	4
OG0007597	1	1	1	1	4
OG0007598	1	1	1	1	4
OG0007599	1	1	1	1	4
OG0007600	1	1	1	1	4
OG0007601	1	1	1	1	4
OG0007602	1	1	1	1	4
OG0007603	1	1	1	1	4
OG0007604	1	1	1	1	4
OG0007605	1	1	1	1	4
OG0007606	1	1	1	1	4
OG0007607	1	1	1	1	4
OG0007608	1	1	1	1	4
OG0007609	1	1	1	1	4
OG0007610	1	1	1	1	4
OG0007611	1	1	1	1	4
OG0007612	1	1	1	1	4
OG0007613	1	1	1	1	4
OG0007614	1	1	1	1	4
OG0007615	1	1	1	1	4
OG0007616	1	1	1	1	4
OG0007617	1	1	1	1	4
OG0007618	1	1	1	1	4
OG0007619	1	1	1	1	4
OG0007620	1	1	1	1	4
OG0007621	1	1	1	1	4
OG0007622	3	0	1	0	4
OG0007623	1	1	1	1	4
OG0007624	1	1	1	1	4
OG0007625	1	1	1	1	4
OG0007626	1	1	1	1	4
OG0007627	1	1	1	1	4
OG0007628	1	1	1	1	4
OG0007629	1	1	1	1	4
OG0007630	1	1	1	1	4
OG0007631	1	1	1	1	4
OG0007632	1	1	1	1	4
OG0007633	1	1	1	1	4
OG0007634	1	1	1	1	4
OG0007635	1	1	1	1	4
OG0007636	1	1	1	1	4
OG0007637	1	1	1	1	4
OG0007638	1	1	1	1	4
OG0007639	1	1	1	1	4
OG0007640	1	1	1	1	4
OG0007641	1	1	1	1	4
OG0007642	1	1	1	1	4
OG0007643	1	1	2	0	4
OG0007644	1	1	1	1	4
OG0007645	1	1	1	1	4
OG0007646	1	1	1	1	4
OG0007647	1	1	1	1	4
OG0007648	1	1	1	1	4
OG0007649	1	1	1	1	4
OG0007650	1	1	1	1	4
OG0007651	1	1	1	1	4
OG0007652	1	1	1	1	4
OG0007653	2	1	1	0	4
OG0007654	1	1	1	1	4
OG0007655	1	1	1	1	4
OG0007656	1	1	1	1	4
OG0007657	1	1	1	1	4
OG0007658	1	1	1	1	4
OG0007659	1	1	1	1	4
OG0007660	1	1	1	1	4
OG0007661	1	1	1	1	4
OG0007662	1	1	1	1	4
OG0007663	1	1	1	1	4
OG0007664	1	1	1	1	4
OG0007665	1	1	1	1	4
OG0007666	1	1	1	1	4
OG0007667	1	1	1	1	4
OG0007668	1	1	1	1	4
OG0007669	1	1	1	1	4
OG0007670	1	1	1	1	4
OG0007671	1	1	1	1	4
OG0007672	1	1	1	1	4
OG0007673	1	1	1	1	4
OG0007674	1	1	1	1	4
OG0007675	1	1	1	1	4
OG0007676	1	1	1	1	4
OG0007677	1	1	1	1	4
OG0007678	1	1	1	1	4
OG0007679	2	1	1	0	4
OG0007680	1	1	1	1	4
OG0007681	1	1	1	1	4
OG0007682	3	1	0	0	4
OG0007683	1	1	1	1	4
OG0007684	1	1	1	1	4
OG0007685	1	1	1	1	4
OG0007686	1	1	1	1	4
OG0007687	1	1	1	1	4
OG0007688	1	0	2	1	4
OG0007689	1	1	1	1	4
OG0007690	1	1	1	1	4
OG0007691	2	1	1	0	4
OG0007692	1	1	1	1	4
OG0007693	1	1	1	1	4
OG0007694	1	1	1	1	4
OG0007695	1	1	1	1	4
OG0007696	1	1	1	1	4
OG0007697	1	1	1	1	4
OG0007698	1	1	1	1	4
OG0007699	1	1	1	1	4
OG0007700	1	1	1	1	4
OG0007701	1	1	1	1	4
OG0007702	2	1	1	0	4
OG0007703	1	1	1	1	4
OG0007704	1	1	1	1	4
OG0007705	1	1	1	1	4
OG0007706	1	1	1	1	4
OG0007707	1	1	1	1	4
OG0007708	1	1	1	1	4
OG0007709	1	1	1	1	4
OG0007710	1	1	1	1	4
OG0007711	1	1	1	1	4
OG0007712	1	1	1	1	4
OG0007713	1	1	1	1	4
OG0007714	1	1	1	1	4
OG0007715	1	1	1	1	4
OG0007716	1	1	1	1	4
OG0007717	1	1	1	1	4
OG0007718	1	1	1	1	4
OG0007719	1	1	1	1	4
OG0007720	1	1	1	1	4
OG0007721	1	1	1	1	4
OG0007722	1	1	1	1	4
OG0007723	1	3	0	0	4
OG0007724	1	1	1	1	4
OG0007725	3	1	0	0	4
OG0007726	1	1	1	1	4
OG0007727	1	1	1	1	4
OG0007728	1	1	1	1	4
OG0007729	1	1	1	1	4
OG0007730	1	1	1	1	4
OG0007731	1	1	1	1	4
OG0007732	1	1	1	1	4
OG0007733	1	1	1	1	4
OG0007734	1	1	1	1	4
OG0007735	1	1	1	1	4
OG0007736	1	1	1	1	4
OG0007737	1	1	1	1	4
OG0007738	1	1	1	1	4
OG0007739	1	1	1	1	4
OG0007740	1	1	1	1	4
OG0007741	1	1	1	1	4
OG0007742	1	1	1	1	4
OG0007743	1	1	1	1	4
OG0007744	1	1	1	1	4
OG0007745	1	1	1	1	4
OG0007746	1	1	1	1	4
OG0007747	1	1	1	1	4
OG0007748	1	1	1	1	4
OG0007749	2	1	1	0	4
OG0007750	1	1	1	1	4
OG0007751	2	1	1	0	4
OG0007752	1	1	1	1	4
OG0007753	1	1	1	1	4
OG0007754	1	1	1	1	4
OG0007755	1	1	1	1	4
OG0007756	1	1	1	1	4
OG0007757	1	1	1	1	4
OG0007758	1	1	1	1	4
OG0007759	1	1	1	1	4
OG0007760	1	1	1	1	4
OG0007761	1	1	1	1	4
OG0007762	1	1	1	1	4
OG0007763	1	1	1	1	4
OG0007764	1	1	1	1	4
OG0007765	2	1	1	0	4
OG0007766	1	1	1	1	4
OG0007767	1	1	1	1	4
OG0007768	1	1	1	1	4
OG0007769	1	1	1	1	4
OG0007770	1	1	1	1	4
OG0007771	1	1	1	1	4
OG0007772	1	1	1	1	4
OG0007773	1	1	1	1	4
OG0007774	1	1	1	1	4
OG0007775	1	2	1	0	4
OG0007776	1	1	1	1	4
OG0007777	1	1	1	1	4
OG0007778	1	1	1	1	4
OG0007779	1	1	1	1	4
OG0007780	1	1	1	1	4
OG0007781	1	1	1	1	4
OG0007782	1	1	1	1	4
OG0007783	1	1	1	1	4
OG0007784	1	1	1	1	4
OG0007785	1	1	1	1	4
OG0007786	1	1	1	1	4
OG0007787	1	1	1	1	4
OG0007788	1	1	1	1	4
OG0007789	1	1	1	1	4
OG0007790	1	1	1	1	4
OG0007791	1	1	1	1	4
OG0007792	1	1	1	1	4
OG0007793	1	1	1	1	4
OG0007794	1	1	1	1	4
OG0007795	1	1	1	1	4
OG0007796	1	1	1	1	4
OG0007797	1	1	1	1	4
OG0007798	1	1	1	1	4
OG0007799	2	1	1	0	4
OG0007800	1	1	1	1	4
OG0007801	1	1	1	1	4
OG0007802	1	1	1	1	4
OG0007803	1	1	1	1	4
OG0007804	1	1	1	1	4
OG0007805	1	1	1	1	4
OG0007806	1	1	1	1	4
OG0007807	1	1	1	1	4
OG0007808	2	1	1	0	4
OG0007809	1	1	1	1	4
OG0007810	1	1	1	1	4
OG0007811	1	1	1	1	4
OG0007812	1	1	1	1	4
OG0007813	1	3	0	0	4
OG0007814	1	1	1	1	4
OG0007815	1	1	1	1	4
OG0007816	1	1	1	1	4
OG0007817	2	1	0	1	4
OG0007818	1	1	1	1	4
OG0007819	1	1	1	1	4
OG0007820	1	1	1	1	4
OG0007821	1	2	1	0	4
OG0007822	2	1	1	0	4
OG0007823	1	1	1	1	4
OG0007824	1	1	1	1	4
OG0007825	1	1	1	1	4
OG0007826	1	1	2	0	4
OG0007827	1	1	1	1	4
OG0007828	1	1	1	1	4
OG0007829	1	1	1	1	4
OG0007830	1	1	1	1	4
OG0007831	1	1	1	1	4
OG0007832	1	1	1	1	4
OG0007833	1	1	1	1	4
OG0007834	1	1	1	1	4
OG0007835	1	1	1	1	4
OG0007836	1	1	1	1	4
OG0007837	1	1	1	1	4
OG0007838	1	1	1	1	4
OG0007839	2	1	1	0	4
OG0007840	1	1	1	1	4
OG0007841	1	2	1	0	4
OG0007842	1	1	1	1	4
OG0007843	1	1	1	1	4
OG0007844	1	1	1	1	4
OG0007845	1	1	1	1	4
OG0007846	1	1	1	1	4
OG0007847	1	1	1	1	4
OG0007848	1	1	1	1	4
OG0007849	1	1	1	1	4
OG0007850	1	1	2	0	4
OG0007851	1	1	1	1	4
OG0007852	1	1	1	1	4
OG0007853	1	1	1	1	4
OG0007854	1	1	1	1	4
OG0007855	1	1	1	1	4
OG0007856	1	1	1	1	4
OG0007857	1	1	1	1	4
OG0007858	1	1	1	1	4
OG0007859	1	1	1	1	4
OG0007860	2	1	1	0	4
OG0007861	1	1	1	1	4
OG0007862	1	1	1	1	4
OG0007863	1	1	1	1	4
OG0007864	1	1	1	1	4
OG0007865	1	1	1	1	4
OG0007866	1	1	1	1	4
OG0007867	1	1	1	1	4
OG0007868	1	1	1	1	4
OG0007869	1	1	1	1	4
OG0007870	1	1	1	1	4
OG0007871	1	1	1	1	4
OG0007872	1	1	1	1	4
OG0007873	1	1	1	1	4
OG0007874	1	1	1	1	4
OG0007875	1	1	1	1	4
OG0007876	1	1	1	1	4
OG0007877	1	1	1	1	4
OG0007878	1	1	1	1	4
OG0007879	1	1	1	1	4
OG0007880	1	1	1	1	4
OG0007881	1	1	1	1	4
OG0007882	1	1	1	1	4
OG0007883	1	1	1	1	4
OG0007884	1	1	1	1	4
OG0007885	1	1	1	1	4
OG0007886	1	1	1	1	4
OG0007887	1	1	1	1	4
OG0007888	1	1	1	1	4
OG0007889	1	1	1	1	4
OG0007890	1	1	1	1	4
OG0007891	1	1	1	1	4
OG0007892	1	1	1	1	4
OG0007893	1	1	1	1	4
OG0007894	1	1	1	1	4
OG0007895	2	1	1	0	4
OG0007896	1	1	1	1	4
OG0007897	1	1	1	1	4
OG0007898	1	1	1	1	4
OG0007899	1	1	1	1	4
OG0007900	1	1	1	1	4
OG0007901	1	1	1	1	4
OG0007902	1	1	1	1	4
OG0007903	1	1	1	1	4
OG0007904	1	1	1	1	4
OG0007905	1	1	1	1	4
OG0007906	1	1	1	1	4
OG0007907	1	1	1	1	4
OG0007908	1	1	1	1	4
OG0007909	1	1	1	1	4
OG0007910	1	1	1	1	4
OG0007911	1	1	1	1	4
OG0007912	1	1	1	1	4
OG0007913	1	1	1	1	4
OG0007914	1	1	1	1	4
OG0007915	1	1	1	1	4
OG0007916	1	1	1	1	4
OG0007917	1	1	1	1	4
OG0007918	1	1	1	1	4
OG0007919	1	1	1	1	4
OG0007920	1	1	1	1	4
OG0007921	1	1	1	1	4
OG0007922	1	1	1	1	4
OG0007923	1	1	1	1	4
OG0007924	1	1	1	1	4
OG0007925	1	1	1	1	4
OG0007926	1	1	1	1	4
OG0007927	1	1	1	1	4
OG0007928	1	1	1	1	4
OG0007929	1	1	1	1	4
OG0007930	1	1	1	1	4
OG0007931	1	1	2	0	4
OG0007932	1	1	1	1	4
OG0007933	1	1	1	1	4
OG0007934	1	1	1	1	4
OG0007935	1	1	1	1	4
OG0007936	1	1	1	1	4
OG0007937	1	1	1	1	4
OG0007938	1	1	1	1	4
OG0007939	1	1	1	1	4
OG0007940	1	1	1	1	4
OG0007941	1	1	1	1	4
OG0007942	1	1	1	1	4
OG0007943	1	1	1	1	4
OG0007944	1	1	1	1	4
OG0007945	2	1	1	0	4
OG0007946	2	2	0	0	4
OG0007947	1	1	1	1	4
OG0007948	1	1	1	1	4
OG0007949	1	1	1	1	4
OG0007950	1	1	1	1	4
OG0007951	1	1	1	1	4
OG0007952	1	1	1	1	4
OG0007953	1	1	1	1	4
OG0007954	1	1	1	1	4
OG0007955	1	1	1	1	4
OG0007956	1	1	1	1	4
OG0007957	1	1	1	1	4
OG0007958	1	1	1	1	4
OG0007959	3	0	0	1	4
OG0007960	1	1	1	1	4
OG0007961	2	1	1	0	4
OG0007962	1	1	1	1	4
OG0007963	2	1	1	0	4
OG0007964	1	1	1	1	4
OG0007965	1	1	1	1	4
OG0007966	2	0	1	1	4
OG0007967	1	1	1	1	4
OG0007968	2	1	1	0	4
OG0007969	2	1	1	0	4
OG0007970	1	1	1	1	4
OG0007971	1	1	1	1	4
OG0007972	1	1	1	1	4
OG0007973	1	1	1	1	4
OG0007974	1	1	1	1	4
OG0007975	1	1	1	1	4
OG0007976	1	1	1	1	4
OG0007977	1	1	1	1	4
OG0007978	2	1	1	0	4
OG0007979	1	1	1	1	4
OG0007980	1	1	1	1	4
OG0007981	1	1	1	1	4
OG0007982	1	1	1	1	4
OG0007983	1	1	1	1	4
OG0007984	1	1	1	1	4
OG0007985	2	1	1	0	4
OG0007986	1	1	1	1	4
OG0007987	1	1	1	1	4
OG0007988	1	1	2	0	4
OG0007989	1	1	1	1	4
OG0007990	1	1	1	1	4
OG0007991	4	0	0	0	4
OG0007992	1	1	2	0	4
OG0007993	1	1	1	1	4
OG0007994	1	1	1	1	4
OG0007995	1	1	1	1	4
OG0007996	1	1	1	1	4
OG0007997	1	1	1	1	4
OG0007998	1	1	1	1	4
OG0007999	1	1	1	1	4
OG0008000	1	1	1	1	4
OG0008001	1	1	1	1	4
OG0008002	1	1	1	1	4
OG0008003	1	1	1	1	4
OG0008004	1	1	1	1	4
OG0008005	1	1	1	1	4
OG0008006	1	1	1	1	4
OG0008007	1	1	1	1	4
OG0008008	1	1	1	1	4
OG0008009	1	1	1	1	4
OG0008010	1	1	1	1	4
OG0008011	2	2	0	0	4
OG0008012	1	1	1	1	4
OG0008013	1	1	1	1	4
OG0008014	1	2	1	0	4
OG0008015	1	1	1	1	4
OG0008016	1	1	1	1	4
OG0008017	1	1	1	1	4
OG0008018	1	1	1	1	4
OG0008019	1	1	1	1	4
OG0008020	1	1	1	1	4
OG0008021	1	1	1	1	4
OG0008022	1	1	1	1	4
OG0008023	1	1	1	1	4
OG0008024	1	1	1	1	4
OG0008025	1	1	1	1	4
OG0008026	1	1	1	1	4
OG0008027	1	1	1	1	4
OG0008028	1	1	1	1	4
OG0008029	1	1	1	1	4
OG0008030	1	1	1	1	4
OG0008031	2	1	1	0	4
OG0008032	1	1	1	1	4
OG0008033	1	1	1	1	4
OG0008034	1	1	1	1	4
OG0008035	1	1	1	1	4
OG0008036	2	1	1	0	4
OG0008037	1	1	1	1	4
OG0008038	1	1	1	1	4
OG0008039	1	1	1	1	4
OG0008040	1	1	1	1	4
OG0008041	1	1	1	1	4
OG0008042	1	1	1	1	4
OG0008043	1	1	1	1	4
OG0008044	1	1	1	1	4
OG0008045	2	1	1	0	4
OG0008046	1	2	0	1	4
OG0008047	3	0	1	0	4
OG0008048	1	1	1	1	4
OG0008049	1	1	1	1	4
OG0008050	1	1	1	1	4
OG0008051	1	1	1	1	4
OG0008052	1	1	1	1	4
OG0008053	1	1	1	1	4
OG0008054	1	1	1	1	4
OG0008055	1	1	1	1	4
OG0008056	1	1	1	1	4
OG0008057	1	1	2	0	4
OG0008058	1	1	1	1	4
OG0008059	1	1	1	1	4
OG0008060	1	1	1	1	4
OG0008061	1	1	1	1	4
OG0008062	1	1	1	1	4
OG0008063	1	1	1	1	4
OG0008064	1	2	1	0	4
OG0008065	1	1	1	1	4
OG0008066	1	1	1	1	4
OG0008067	1	1	1	1	4
OG0008068	1	0	3	0	4
OG0008069	1	1	2	0	4
OG0008070	1	1	1	1	4
OG0008071	1	1	1	1	4
OG0008072	1	1	1	1	4
OG0008073	1	1	1	1	4
OG0008074	1	1	1	1	4
OG0008075	1	1	1	1	4
OG0008076	1	1	1	1	4
OG0008077	1	1	1	1	4
OG0008078	1	1	1	1	4
OG0008079	1	1	1	1	4
OG0008080	1	1	1	1	4
OG0008081	1	1	1	1	4
OG0008082	1	1	1	1	4
OG0008083	1	1	1	1	4
OG0008084	1	1	1	1	4
OG0008085	1	1	1	1	4
OG0008086	2	1	1	0	4
OG0008087	1	1	1	1	4
OG0008088	1	1	2	0	4
OG0008089	1	1	1	1	4
OG0008090	1	1	1	1	4
OG0008091	1	1	1	1	4
OG0008092	1	1	1	1	4
OG0008093	1	1	1	1	4
OG0008094	1	1	1	1	4
OG0008095	1	1	1	1	4
OG0008096	1	1	1	1	4
OG0008097	1	1	1	1	4
OG0008098	1	1	1	1	4
OG0008099	1	1	1	1	4
OG0008100	1	1	1	1	4
OG0008101	1	1	1	1	4
OG0008102	1	1	1	1	4
OG0008103	1	1	1	1	4
OG0008104	1	1	1	1	4
OG0008105	1	1	1	1	4
OG0008106	2	1	1	0	4
OG0008107	1	1	1	1	4
OG0008108	1	1	1	1	4
OG0008109	1	1	1	1	4
OG0008110	1	1	1	1	4
OG0008111	1	1	1	1	4
OG0008112	1	1	1	1	4
OG0008113	1	1	1	1	4
OG0008114	1	1	1	1	4
OG0008115	1	1	1	1	4
OG0008116	1	1	1	1	4
OG0008117	1	1	1	1	4
OG0008118	1	1	1	1	4
OG0008119	1	1	1	1	4
OG0008120	2	2	0	0	4
OG0008121	1	1	1	1	4
OG0008122	1	1	1	1	4
OG0008123	1	1	1	1	4
OG0008124	1	1	1	1	4
OG0008125	1	1	1	1	4
OG0008126	1	1	1	1	4
OG0008127	1	1	1	1	4
OG0008128	1	1	1	1	4
OG0008129	1	1	1	1	4
OG0008130	1	1	1	1	4
OG0008131	1	1	1	1	4
OG0008132	1	1	1	1	4
OG0008133	1	1	1	1	4
OG0008134	1	1	1	1	4
OG0008135	2	1	1	0	4
OG0008136	1	1	1	1	4
OG0008137	1	1	1	1	4
OG0008138	1	1	1	1	4
OG0008139	1	1	1	1	4
OG0008140	1	1	1	1	4
OG0008141	1	1	1	1	4
OG0008142	1	1	1	1	4
OG0008143	1	1	1	1	4
OG0008144	1	1	1	1	4
OG0008145	1	1	1	1	4
OG0008146	1	1	1	1	4
OG0008147	1	2	1	0	4
OG0008148	1	2	1	0	4
OG0008149	1	1	1	1	4
OG0008150	1	1	1	1	4
OG0008151	1	1	1	1	4
OG0008152	1	1	1	1	4
OG0008153	1	1	1	1	4
OG0008154	2	1	1	0	4
OG0008155	1	1	1	1	4
OG0008156	1	1	1	1	4
OG0008157	1	2	1	0	4
OG0008158	1	1	1	1	4
OG0008159	1	1	1	1	4
OG0008160	1	1	1	1	4
OG0008161	2	1	1	0	4
OG0008162	1	1	1	1	4
OG0008163	1	1	1	1	4
OG0008164	1	1	1	1	4
OG0008165	1	1	1	1	4
OG0008166	1	1	1	1	4
OG0008167	1	1	1	1	4
OG0008168	1	1	1	1	4
OG0008169	1	1	1	1	4
OG0008170	1	1	1	1	4
OG0008171	1	1	1	1	4
OG0008172	1	1	1	1	4
OG0008173	1	1	1	1	4
OG0008174	1	1	2	0	4
OG0008175	1	1	0	2	4
OG0008176	2	1	1	0	4
OG0008177	1	1	1	1	4
OG0008178	1	1	1	1	4
OG0008179	1	1	1	1	4
OG0008180	1	1	1	1	4
OG0008181	1	1	1	1	4
OG0008182	1	1	1	1	4
OG0008183	1	1	1	1	4
OG0008184	1	1	1	1	4
OG0008185	1	1	1	1	4
OG0008186	4	0	0	0	4
OG0008187	1	1	1	1	4
OG0008188	1	1	1	1	4
OG0008189	1	2	1	0	4
OG0008190	1	1	1	1	4
OG0008191	1	1	1	1	4
OG0008192	1	1	1	1	4
OG0008193	1	1	1	1	4
OG0008194	1	1	1	1	4
OG0008195	1	1	1	1	4
OG0008196	1	1	1	1	4
OG0008197	1	1	1	1	4
OG0008198	1	1	1	1	4
OG0008199	1	1	1	1	4
OG0008200	1	1	1	1	4
OG0008201	1	1	1	1	4
OG0008202	1	1	1	1	4
OG0008203	1	1	1	1	4
OG0008204	1	1	1	1	4
OG0008205	1	1	2	0	4
OG0008206	1	1	1	1	4
OG0008207	1	1	1	1	4
OG0008208	1	1	1	1	4
OG0008209	1	1	1	1	4
OG0008210	1	1	1	1	4
OG0008211	1	1	2	0	4
OG0008212	1	1	1	1	4
OG0008213	1	1	1	1	4
OG0008214	1	1	1	1	4
OG0008215	2	1	1	0	4
OG0008216	1	1	1	1	4
OG0008217	1	1	1	1	4
OG0008218	1	1	1	1	4
OG0008219	1	1	1	1	4
OG0008220	1	1	1	1	4
OG0008221	1	1	1	1	4
OG0008222	1	1	1	1	4
OG0008223	1	1	1	1	4
OG0008224	1	1	1	1	4
OG0008225	1	1	1	1	4
OG0008226	1	1	1	1	4
OG0008227	1	1	1	1	4
OG0008228	1	1	1	1	4
OG0008229	1	1	1	1	4
OG0008230	1	1	1	1	4
OG0008231	1	1	1	1	4
OG0008232	1	1	1	1	4
OG0008233	1	1	1	1	4
OG0008234	1	1	1	1	4
OG0008235	1	1	1	1	4
OG0008236	1	1	1	1	4
OG0008237	1	1	1	1	4
OG0008238	1	1	1	1	4
OG0008239	1	1	1	1	4
OG0008240	1	1	1	1	4
OG0008241	1	1	1	1	4
OG0008242	1	1	1	1	4
OG0008243	1	1	1	1	4
OG0008244	1	1	1	1	4
OG0008245	1	1	1	1	4
OG0008246	1	1	1	1	4
OG0008247	1	1	1	1	4
OG0008248	1	1	1	1	4
OG0008249	1	1	1	1	4
OG0008250	2	1	1	0	4
OG0008251	1	1	1	1	4
OG0008252	1	1	1	1	4
OG0008253	1	1	1	1	4
OG0008254	1	1	1	1	4
OG0008255	2	0	0	2	4
OG0008256	1	1	2	0	4
OG0008257	1	1	1	1	4
OG0008258	1	1	1	1	4
OG0008259	1	1	1	1	4
OG0008260	1	1	1	1	4
OG0008261	1	1	1	1	4
OG0008262	1	1	1	1	4
OG0008263	1	1	1	1	4
OG0008264	1	1	1	1	4
OG0008265	1	1	1	1	4
OG0008266	1	1	1	1	4
OG0008267	1	1	1	1	4
OG0008268	1	1	1	1	4
OG0008269	1	1	1	1	4
OG0008270	1	1	1	1	4
OG0008271	1	1	1	1	4
OG0008272	1	1	1	1	4
OG0008273	1	1	1	1	4
OG0008274	1	1	1	1	4
OG0008275	1	1	1	1	4
OG0008276	1	1	1	1	4
OG0008277	1	1	1	1	4
OG0008278	1	1	1	1	4
OG0008279	1	1	1	1	4
OG0008280	1	1	1	1	4
OG0008281	1	1	1	1	4
OG0008282	1	1	1	1	4
OG0008283	1	1	1	1	4
OG0008284	1	1	1	1	4
OG0008285	1	1	1	1	4
OG0008286	1	1	1	1	4
OG0008287	1	1	1	1	4
OG0008288	1	1	1	1	4
OG0008289	1	1	1	1	4
OG0008290	1	1	1	1	4
OG0008291	1	1	1	1	4
OG0008292	1	1	1	1	4
OG0008293	1	1	1	1	4
OG0008294	1	1	1	1	4
OG0008295	1	1	1	1	4
OG0008296	1	1	1	1	4
OG0008297	1	1	1	1	4
OG0008298	1	1	1	1	4
OG0008299	1	1	1	1	4
OG0008300	1	1	1	1	4
OG0008301	1	1	1	1	4
OG0008302	1	1	1	1	4
OG0008303	1	1	1	1	4
OG0008304	1	1	1	1	4
OG0008305	1	1	1	1	4
OG0008306	2	1	1	0	4
OG0008307	1	1	1	1	4
OG0008308	1	1	1	1	4
OG0008309	1	1	1	1	4
OG0008310	1	1	1	1	4
OG0008311	1	1	1	1	4
OG0008312	1	1	1	1	4
OG0008313	1	1	1	1	4
OG0008314	1	1	1	1	4
OG0008315	1	1	1	1	4
OG0008316	1	1	1	1	4
OG0008317	2	1	1	0	4
OG0008318	1	1	1	1	4
OG0008319	1	1	1	1	4
OG0008320	1	2	1	0	4
OG0008321	1	1	1	1	4
OG0008322	1	1	1	1	4
OG0008323	1	1	1	1	4
OG0008324	1	1	1	1	4
OG0008325	1	1	1	1	4
OG0008326	1	1	1	1	4
OG0008327	1	1	1	1	4
OG0008328	1	1	1	1	4
OG0008329	1	1	1	1	4
OG0008330	1	1	1	1	4
OG0008331	1	1	1	1	4
OG0008332	1	1	1	1	4
OG0008333	1	1	1	1	4
OG0008334	1	1	1	1	4
OG0008335	1	1	1	1	4
OG0008336	1	1	1	1	4
OG0008337	2	0	1	1	4
OG0008338	1	1	1	1	4
OG0008339	1	1	1	1	4
OG0008340	1	1	1	1	4
OG0008341	2	1	1	0	4
OG0008342	1	1	1	1	4
OG0008343	1	1	1	1	4
OG0008344	1	1	1	1	4
OG0008345	1	1	1	1	4
OG0008346	1	1	1	1	4
OG0008347	1	1	1	1	4
OG0008348	1	0	1	2	4
OG0008349	1	1	1	1	4
OG0008350	1	1	1	1	4
OG0008351	1	1	1	1	4
OG0008352	1	1	1	1	4
OG0008353	1	1	1	1	4
OG0008354	1	1	1	1	4
OG0008355	1	1	1	1	4
OG0008356	4	0	0	0	4
OG0008357	1	1	1	1	4
OG0008358	1	1	1	1	4
OG0008359	1	1	1	1	4
OG0008360	1	1	1	1	4
OG0008361	1	1	1	1	4
OG0008362	1	1	1	1	4
OG0008363	1	1	1	1	4
OG0008364	2	1	1	0	4
OG0008365	1	1	1	1	4
OG0008366	1	1	1	1	4
OG0008367	1	1	1	1	4
OG0008368	1	1	1	1	4
OG0008369	1	1	1	1	4
OG0008370	1	1	1	1	4
OG0008371	1	1	1	1	4
OG0008372	2	1	1	0	4
OG0008373	1	1	1	1	4
OG0008374	1	1	1	1	4
OG0008375	4	0	0	0	4
OG0008376	1	1	1	1	4
OG0008377	3	1	0	0	4
OG0008378	1	1	1	1	4
OG0008379	1	1	1	1	4
OG0008380	1	1	1	1	4
OG0008381	1	1	1	1	4
OG0008382	1	1	1	1	4
OG0008383	1	1	1	1	4
OG0008384	1	1	1	1	4
OG0008385	1	1	1	1	4
OG0008386	1	1	1	1	4
OG0008387	1	1	1	1	4
OG0008388	1	1	1	1	4
OG0008389	1	1	1	1	4
OG0008390	1	1	1	1	4
OG0008391	1	1	1	1	4
OG0008392	1	1	1	1	4
OG0008393	1	1	1	1	4
OG0008394	1	1	1	1	4
OG0008395	1	1	1	1	4
OG0008396	2	1	1	0	4
OG0008397	2	1	0	1	4
OG0008398	1	1	1	1	4
OG0008399	1	1	1	1	4
OG0008400	1	1	1	1	4
OG0008401	1	1	1	1	4
OG0008402	1	1	1	1	4
OG0008403	1	1	1	1	4
OG0008404	1	1	1	1	4
OG0008405	1	1	1	1	4
OG0008406	1	1	1	1	4
OG0008407	1	1	1	1	4
OG0008408	1	1	1	1	4
OG0008409	1	1	1	1	4
OG0008410	1	1	1	1	4
OG0008411	1	2	1	0	4
OG0008412	1	1	1	1	4
OG0008413	1	1	1	1	4
OG0008414	1	1	1	1	4
OG0008415	1	1	1	1	4
OG0008416	1	1	1	1	4
OG0008417	1	1	1	1	4
OG0008418	1	1	1	1	4
OG0008419	1	1	1	1	4
OG0008420	1	1	1	1	4
OG0008421	1	1	1	1	4
OG0008422	1	1	1	1	4
OG0008423	1	1	1	1	4
OG0008424	1	1	1	1	4
OG0008425	1	1	1	1	4
OG0008426	1	1	1	1	4
OG0008427	1	1	1	1	4
OG0008428	1	1	1	1	4
OG0008429	1	1	1	1	4
OG0008430	1	1	1	1	4
OG0008431	1	1	1	1	4
OG0008432	1	1	1	1	4
OG0008433	1	1	1	1	4
OG0008434	1	1	1	1	4
OG0008435	1	1	1	1	4
OG0008436	1	1	1	1	4
OG0008437	1	1	1	1	4
OG0008438	1	1	1	1	4
OG0008439	1	1	1	1	4
OG0008440	1	1	1	1	4
OG0008441	1	1	2	0	4
OG0008442	1	1	1	1	4
OG0008443	1	1	1	1	4
OG0008444	1	1	1	1	4
OG0008445	1	1	1	1	4
OG0008446	1	1	1	1	4
OG0008447	1	1	1	1	4
OG0008448	1	1	1	1	4
OG0008449	4	0	0	0	4
OG0008450	1	1	1	1	4
OG0008451	1	1	1	1	4
OG0008452	3	0	1	0	4
OG0008453	1	1	1	1	4
OG0008454	1	1	1	1	4
OG0008455	1	1	1	1	4
OG0008456	1	1	1	1	4
OG0008457	1	1	1	1	4
OG0008458	1	1	1	1	4
OG0008459	1	1	1	1	4
OG0008460	1	1	1	1	4
OG0008461	1	1	1	1	4
OG0008462	1	1	1	1	4
OG0008463	1	1	1	1	4
OG0008464	1	1	1	1	4
OG0008465	1	1	1	1	4
OG0008466	1	1	1	1	4
OG0008467	1	1	2	0	4
OG0008468	1	1	1	1	4
OG0008469	1	1	1	1	4
OG0008470	2	2	0	0	4
OG0008471	1	1	1	1	4
OG0008472	1	1	1	1	4
OG0008473	1	1	1	1	4
OG0008474	1	1	1	1	4
OG0008475	1	1	1	1	4
OG0008476	1	1	1	1	4
OG0008477	1	1	1	1	4
OG0008478	1	1	1	1	4
OG0008479	1	1	1	1	4
OG0008480	3	0	1	0	4
OG0008481	1	1	1	1	4
OG0008482	1	1	1	1	4
OG0008483	1	1	1	1	4
OG0008484	1	1	1	1	4
OG0008485	1	1	1	1	4
OG0008486	1	1	1	1	4
OG0008487	1	1	1	1	4
OG0008488	1	1	1	1	4
OG0008489	1	1	1	1	4
OG0008490	1	1	1	1	4
OG0008491	1	1	1	1	4
OG0008492	1	1	1	1	4
OG0008493	1	1	1	1	4
OG0008494	1	1	1	1	4
OG0008495	1	1	1	1	4
OG0008496	1	1	1	1	4
OG0008497	1	1	1	1	4
OG0008498	1	1	1	1	4
OG0008499	1	1	1	1	4
OG0008500	1	1	1	1	4
OG0008501	1	1	1	1	4
OG0008502	2	0	2	0	4
OG0008503	1	1	1	1	4
OG0008504	4	0	0	0	4
OG0008505	1	1	1	1	4
OG0008506	1	0	3	0	4
OG0008507	1	1	1	1	4
OG0008508	1	1	1	1	4
OG0008509	1	1	1	1	4
OG0008510	1	1	1	1	4
OG0008511	1	1	1	1	4
OG0008512	1	1	1	1	4
OG0008513	1	1	1	1	4
OG0008514	1	1	1	1	4
OG0008515	1	1	1	1	4
OG0008516	1	1	1	1	4
OG0008517	1	1	1	1	4
OG0008518	1	1	1	1	4
OG0008519	1	1	1	1	4
OG0008520	1	1	1	1	4
OG0008521	1	1	1	1	4
OG0008522	1	1	1	1	4
OG0008523	1	1	1	1	4
OG0008524	1	1	1	1	4
OG0008525	1	1	1	1	4
OG0008526	1	1	1	1	4
OG0008527	1	1	1	1	4
OG0008528	1	1	1	1	4
OG0008529	1	1	1	1	4
OG0008530	1	1	1	1	4
OG0008531	1	1	1	1	4
OG0008532	1	1	1	1	4
OG0008533	1	1	1	1	4
OG0008534	1	1	1	1	4
OG0008535	2	1	1	0	4
OG0008536	1	1	1	1	4
OG0008537	1	1	1	1	4
OG0008538	1	1	1	1	4
OG0008539	1	1	1	1	4
OG0008540	1	1	1	1	4
OG0008541	1	1	1	1	4
OG0008542	1	1	1	1	4
OG0008543	1	1	1	1	4
OG0008544	1	1	1	1	4
OG0008545	1	1	1	1	4
OG0008546	1	1	1	1	4
OG0008547	1	1	1	1	4
OG0008548	1	1	1	1	4
OG0008549	1	1	1	1	4
OG0008550	1	1	1	1	4
OG0008551	1	1	1	1	4
OG0008552	1	1	1	1	4
OG0008553	1	1	1	1	4
OG0008554	1	1	1	1	4
OG0008555	1	1	1	1	4
OG0008556	1	1	1	1	4
OG0008557	1	1	1	1	4
OG0008558	1	1	1	1	4
OG0008559	1	1	1	1	4
OG0008560	1	1	1	1	4
OG0008561	1	1	1	1	4
OG0008562	1	1	1	1	4
OG0008563	1	1	1	1	4
OG0008564	1	1	1	1	4
OG0008565	1	1	1	1	4
OG0008566	1	1	1	1	4
OG0008567	1	1	1	1	4
OG0008568	2	1	1	0	4
OG0008569	1	1	1	1	4
OG0008570	1	1	1	1	4
OG0008571	1	1	1	1	4
OG0008572	1	1	1	1	4
OG0008573	1	1	1	1	4
OG0008574	1	1	1	1	4
OG0008575	1	1	1	1	4
OG0008576	1	1	1	1	4
OG0008577	1	1	1	1	4
OG0008578	1	1	1	1	4
OG0008579	1	0	3	0	4
OG0008580	1	1	2	0	4
OG0008581	1	1	1	1	4
OG0008582	1	1	1	1	4
OG0008583	1	1	1	1	4
OG0008584	1	1	1	1	4
OG0008585	1	1	1	1	4
OG0008586	1	1	1	1	4
OG0008587	1	1	1	1	4
OG0008588	1	1	1	1	4
OG0008589	1	1	1	1	4
OG0008590	1	1	1	1	4
OG0008591	1	1	1	1	4
OG0008592	1	1	1	1	4
OG0008593	4	0	0	0	4
OG0008594	1	1	1	1	4
OG0008595	1	1	1	1	4
OG0008596	1	1	1	1	4
OG0008597	1	1	1	1	4
OG0008598	1	1	1	1	4
OG0008599	1	1	1	1	4
OG0008600	1	1	1	1	4
OG0008601	2	1	1	0	4
OG0008602	1	1	1	1	4
OG0008603	1	1	1	1	4
OG0008604	1	1	1	1	4
OG0008605	1	1	1	1	4
OG0008606	3	0	1	0	4
OG0008607	1	1	1	1	4
OG0008608	1	1	1	1	4
OG0008609	1	1	1	1	4
OG0008610	2	0	1	1	4
OG0008611	1	1	1	1	4
OG0008612	1	1	1	1	4
OG0008613	1	1	1	1	4
OG0008614	1	1	1	1	4
OG0008615	1	1	1	1	4
OG0008616	1	1	1	1	4
OG0008617	1	1	1	1	4
OG0008618	1	1	1	1	4
OG0008619	1	1	1	1	4
OG0008620	1	1	1	1	4
OG0008621	1	1	1	1	4
OG0008622	1	0	3	0	4
OG0008623	1	1	1	1	4
OG0008624	3	0	1	0	4
OG0008625	1	1	1	1	4
OG0008626	2	1	1	0	4
OG0008627	1	1	1	1	4
OG0008628	1	1	1	1	4
OG0008629	1	1	1	1	4
OG0008630	1	1	1	1	4
OG0008631	1	1	1	1	4
OG0008632	1	1	1	1	4
OG0008633	1	1	1	1	4
OG0008634	1	1	1	1	4
OG0008635	1	1	1	1	4
OG0008636	1	1	1	1	4
OG0008637	1	1	2	0	4
OG0008638	2	1	1	0	4
OG0008639	1	1	1	1	4
OG0008640	1	1	1	1	4
OG0008641	1	1	1	1	4
OG0008642	1	1	1	1	4
OG0008643	1	1	1	1	4
OG0008644	1	1	1	1	4
OG0008645	1	1	1	1	4
OG0008646	1	1	1	1	4
OG0008647	1	1	1	1	4
OG0008648	1	1	1	1	4
OG0008649	1	1	2	0	4
OG0008650	1	1	1	1	4
OG0008651	1	1	1	1	4
OG0008652	2	1	1	0	4
OG0008653	1	1	1	1	4
OG0008654	1	1	1	1	4
OG0008655	1	1	1	1	4
OG0008656	1	1	1	1	4
OG0008657	1	1	1	1	4
OG0008658	1	1	1	1	4
OG0008659	1	1	1	1	4
OG0008660	1	1	1	1	4
OG0008661	1	1	1	1	4
OG0008662	1	1	1	1	4
OG0008663	1	1	1	1	4
OG0008664	1	1	1	1	4
OG0008665	1	1	1	1	4
OG0008666	1	1	1	1	4
OG0008667	1	1	1	1	4
OG0008668	1	1	1	1	4
OG0008669	1	1	1	1	4
OG0008670	1	1	2	0	4
OG0008671	1	2	1	0	4
OG0008672	1	1	1	1	4
OG0008673	1	1	1	1	4
OG0008674	1	1	1	1	4
OG0008675	1	1	1	1	4
OG0008676	1	1	1	1	4
OG0008677	1	1	1	1	4
OG0008678	1	1	1	1	4
OG0008679	1	1	1	1	4
OG0008680	4	0	0	0	4
OG0008681	1	1	1	1	4
OG0008682	1	1	1	1	4
OG0008683	1	1	1	1	4
OG0008684	1	1	1	1	4
OG0008685	1	1	1	1	4
OG0008686	1	1	1	1	4
OG0008687	1	1	1	1	4
OG0008688	1	1	1	1	4
OG0008689	1	1	1	1	4
OG0008690	1	1	1	1	4
OG0008691	1	1	1	1	4
OG0008692	1	1	1	1	4
OG0008693	1	1	1	1	4
OG0008694	1	1	1	1	4
OG0008695	1	1	1	1	4
OG0008696	1	1	1	1	4
OG0008697	1	1	1	1	4
OG0008698	1	1	1	1	4
OG0008699	1	1	2	0	4
OG0008700	1	1	1	1	4
OG0008701	1	1	1	1	4
OG0008702	1	1	1	1	4
OG0008703	1	1	1	1	4
OG0008704	1	1	1	1	4
OG0008705	1	1	1	1	4
OG0008706	1	1	1	1	4
OG0008707	1	1	1	1	4
OG0008708	1	1	2	0	4
OG0008709	1	1	1	1	4
OG0008710	1	0	1	2	4
OG0008711	1	1	1	1	4
OG0008712	1	1	1	1	4
OG0008713	2	1	1	0	4
OG0008714	1	1	1	1	4
OG0008715	1	1	2	0	4
OG0008716	1	1	1	1	4
OG0008717	1	1	1	1	4
OG0008718	1	1	1	1	4
OG0008719	1	1	1	1	4
OG0008720	1	1	1	1	4
OG0008721	1	1	1	1	4
OG0008722	1	1	1	1	4
OG0008723	1	1	1	1	4
OG0008724	1	1	1	1	4
OG0008725	1	1	1	1	4
OG0008726	1	1	1	1	4
OG0008727	1	1	1	1	4
OG0008728	1	1	1	1	4
OG0008729	1	1	1	1	4
OG0008730	1	1	1	1	4
OG0008731	1	1	1	1	4
OG0008732	1	1	1	1	4
OG0008733	1	1	1	1	4
OG0008734	1	1	1	1	4
OG0008735	1	1	1	1	4
OG0008736	1	1	1	1	4
OG0008737	1	1	1	1	4
OG0008738	1	1	1	1	4
OG0008739	1	1	1	1	4
OG0008740	1	1	1	1	4
OG0008741	1	1	1	1	4
OG0008742	1	1	1	1	4
OG0008743	1	1	1	1	4
OG0008744	1	1	1	1	4
OG0008745	1	1	1	1	4
OG0008746	1	1	1	1	4
OG0008747	1	1	1	1	4
OG0008748	1	1	1	1	4
OG0008749	1	1	1	1	4
OG0008750	1	1	1	1	4
OG0008751	1	1	1	1	4
OG0008752	1	1	1	1	4
OG0008753	1	2	1	0	4
OG0008754	1	1	1	1	4
OG0008755	1	1	1	1	4
OG0008756	1	1	1	1	4
OG0008757	1	1	1	1	4
OG0008758	4	0	0	0	4
OG0008759	1	1	1	1	4
OG0008760	1	1	1	1	4
OG0008761	1	1	1	1	4
OG0008762	1	1	1	1	4
OG0008763	1	1	1	1	4
OG0008764	1	1	1	1	4
OG0008765	1	1	1	1	4
OG0008766	1	1	1	1	4
OG0008767	1	1	1	1	4
OG0008768	1	1	1	1	4
OG0008769	1	1	1	1	4
OG0008770	1	1	1	1	4
OG0008771	1	1	1	1	4
OG0008772	1	1	1	1	4
OG0008773	1	1	1	1	4
OG0008774	1	1	1	1	4
OG0008775	1	1	1	1	4
OG0008776	1	1	1	1	4
OG0008777	1	1	1	1	4
OG0008778	1	1	1	1	4
OG0008779	1	1	1	1	4
OG0008780	1	1	1	1	4
OG0008781	1	1	1	1	4
OG0008782	1	1	1	1	4
OG0008783	1	1	1	1	4
OG0008784	1	1	1	1	4
OG0008785	1	1	1	1	4
OG0008786	1	1	1	1	4
OG0008787	1	1	1	1	4
OG0008788	1	1	1	1	4
OG0008789	1	1	1	1	4
OG0008790	1	1	1	1	4
OG0008791	1	1	1	1	4
OG0008792	1	1	1	1	4
OG0008793	1	1	1	1	4
OG0008794	1	1	1	1	4
OG0008795	1	0	1	2	4
OG0008796	1	1	1	1	4
OG0008797	1	1	1	1	4
OG0008798	1	1	1	1	4
OG0008799	1	1	1	1	4
OG0008800	1	1	1	1	4
OG0008801	1	1	1	1	4
OG0008802	1	1	1	1	4
OG0008803	1	1	1	1	4
OG0008804	1	1	1	1	4
OG0008805	1	1	1	1	4
OG0008806	1	1	1	1	4
OG0008807	1	1	1	1	4
OG0008808	1	0	3	0	4
OG0008809	1	1	1	1	4
OG0008810	1	1	1	1	4
OG0008811	1	1	1	1	4
OG0008812	1	1	1	1	4
OG0008813	1	1	1	1	4
OG0008814	1	1	1	1	4
OG0008815	1	1	1	1	4
OG0008816	1	1	1	1	4
OG0008817	1	1	1	1	4
OG0008818	1	1	1	1	4
OG0008819	1	1	1	1	4
OG0008820	1	1	1	1	4
OG0008821	1	1	1	1	4
OG0008822	1	1	1	1	4
OG0008823	1	1	1	1	4
OG0008824	1	1	1	1	4
OG0008825	1	1	1	1	4
OG0008826	1	1	1	1	4
OG0008827	2	0	2	0	4
OG0008828	1	1	1	1	4
OG0008829	1	1	1	1	4
OG0008830	1	1	1	1	4
OG0008831	1	1	1	1	4
OG0008832	3	1	0	0	4
OG0008833	1	1	1	1	4
OG0008834	1	1	1	1	4
OG0008835	1	1	1	1	4
OG0008836	1	1	1	1	4
OG0008837	1	1	1	1	4
OG0008838	1	1	1	1	4
OG0008839	1	1	1	1	4
OG0008840	1	1	1	1	4
OG0008841	1	1	1	1	4
OG0008842	1	1	1	1	4
OG0008843	1	1	1	1	4
OG0008844	1	1	1	1	4
OG0008845	1	1	1	1	4
OG0008846	1	1	1	1	4
OG0008847	1	1	1	1	4
OG0008848	1	0	3	0	4
OG0008849	1	1	1	1	4
OG0008850	1	1	1	1	4
OG0008851	2	1	1	0	4
OG0008852	1	1	1	1	4
OG0008853	1	1	1	1	4
OG0008854	2	1	1	0	4
OG0008855	1	1	1	1	4
OG0008856	1	2	1	0	4
OG0008857	1	1	1	1	4
OG0008858	1	1	1	1	4
OG0008859	1	1	1	1	4
OG0008860	1	0	3	0	4
OG0008861	1	1	1	1	4
OG0008862	1	1	1	1	4
OG0008863	1	1	1	1	4
OG0008864	1	1	1	1	4
OG0008865	1	1	1	1	4
OG0008866	1	1	1	1	4
OG0008867	1	1	1	1	4
OG0008868	1	1	1	1	4
OG0008869	1	1	1	1	4
OG0008870	1	1	1	1	4
OG0008871	1	1	1	1	4
OG0008872	1	1	1	1	4
OG0008873	1	1	1	1	4
OG0008874	1	1	1	1	4
OG0008875	1	1	1	1	4
OG0008876	1	1	1	1	4
OG0008877	1	1	1	1	4
OG0008878	1	1	1	1	4
OG0008879	1	1	1	1	4
OG0008880	1	1	1	1	4
OG0008881	1	1	1	1	4
OG0008882	1	1	1	1	4
OG0008883	1	1	1	1	4
OG0008884	1	1	1	1	4
OG0008885	1	1	1	1	4
OG0008886	1	1	1	1	4
OG0008887	1	1	1	1	4
OG0008888	1	1	1	1	4
OG0008889	1	1	1	1	4
OG0008890	1	1	1	1	4
OG0008891	1	1	1	1	4
OG0008892	2	1	1	0	4
OG0008893	1	1	1	1	4
OG0008894	1	1	1	1	4
OG0008895	1	1	1	1	4
OG0008896	1	1	1	1	4
OG0008897	1	1	1	1	4
OG0008898	1	1	1	1	4
OG0008899	1	1	1	1	4
OG0008900	1	1	1	1	4
OG0008901	1	1	1	1	4
OG0008902	1	1	1	1	4
OG0008903	1	1	1	1	4
OG0008904	2	1	1	0	4
OG0008905	1	1	1	1	4
OG0008906	1	1	1	1	4
OG0008907	1	1	1	1	4
OG0008908	1	1	1	1	4
OG0008909	1	1	1	1	4
OG0008910	1	1	1	1	4
OG0008911	1	1	1	1	4
OG0008912	1	1	1	1	4
OG0008913	4	0	0	0	4
OG0008914	1	1	1	1	4
OG0008915	1	0	3	0	4
OG0008916	1	1	1	1	4
OG0008917	1	1	1	1	4
OG0008918	1	1	1	1	4
OG0008919	1	1	1	1	4
OG0008920	1	1	1	1	4
OG0008921	1	1	1	1	4
OG0008922	1	1	1	1	4
OG0008923	1	1	1	1	4
OG0008924	1	1	1	1	4
OG0008925	1	1	1	1	4
OG0008926	2	1	1	0	4
OG0008927	1	1	1	1	4
OG0008928	1	1	1	1	4
OG0008929	2	1	1	0	4
OG0008930	1	1	1	1	4
OG0008931	4	0	0	0	4
OG0008932	1	1	1	1	4
OG0008933	1	1	1	1	4
OG0008934	1	1	1	1	4
OG0008935	1	1	1	1	4
OG0008936	1	1	1	1	4
OG0008937	1	1	1	1	4
OG0008938	1	1	1	1	4
OG0008939	1	1	1	1	4
OG0008940	1	1	1	1	4
OG0008941	1	1	1	1	4
OG0008942	1	1	1	1	4
OG0008943	1	1	1	1	4
OG0008944	1	1	1	1	4
OG0008945	1	1	1	1	4
OG0008946	1	1	1	1	4
OG0008947	1	1	1	1	4
OG0008948	1	1	1	1	4
OG0008949	1	1	1	1	4
OG0008950	1	1	1	1	4
OG0008951	1	1	1	1	4
OG0008952	1	1	1	1	4
OG0008953	1	1	1	1	4
OG0008954	1	1	1	1	4
OG0008955	1	1	1	1	4
OG0008956	2	2	0	0	4
OG0008957	1	2	1	0	4
OG0008958	1	1	1	1	4
OG0008959	1	1	1	1	4
OG0008960	1	1	2	0	4
OG0008961	1	1	1	1	4
OG0008962	1	1	1	1	4
OG0008963	1	1	1	1	4
OG0008964	1	1	1	1	4
OG0008965	3	0	0	1	4
OG0008966	2	1	1	0	4
OG0008967	1	1	1	1	4
OG0008968	1	1	1	1	4
OG0008969	1	1	1	1	4
OG0008970	1	1	1	1	4
OG0008971	2	1	1	0	4
OG0008972	1	1	1	1	4
OG0008973	1	1	1	1	4
OG0008974	1	1	1	1	4
OG0008975	1	1	1	1	4
OG0008976	1	1	1	1	4
OG0008977	1	1	1	1	4
OG0008978	1	1	1	1	4
OG0008979	1	1	1	1	4
OG0008980	2	1	1	0	4
OG0008981	1	1	1	1	4
OG0008982	1	1	1	1	4
OG0008983	1	1	1	1	4
OG0008984	1	0	3	0	4
OG0008985	1	1	1	1	4
OG0008986	1	1	1	1	4
OG0008987	2	1	1	0	4
OG0008988	1	1	1	1	4
OG0008989	1	1	1	1	4
OG0008990	2	1	1	0	4
OG0008991	1	1	1	1	4
OG0008992	1	1	1	1	4
OG0008993	1	1	1	1	4
OG0008994	1	1	1	1	4
OG0008995	1	1	1	1	4
OG0008996	1	1	1	1	4
OG0008997	1	1	1	1	4
OG0008998	1	1	1	1	4
OG0008999	1	1	1	1	4
OG0009000	1	1	1	1	4
OG0009001	1	1	1	1	4
OG0009002	1	1	1	1	4
OG0009003	1	1	1	1	4
OG0009004	1	1	1	1	4
OG0009005	1	1	1	1	4
OG0009006	1	1	1	1	4
OG0009007	1	1	1	1	4
OG0009008	1	1	1	1	4
OG0009009	1	1	1	1	4
OG0009010	1	1	1	1	4
OG0009011	1	1	1	1	4
OG0009012	1	1	1	1	4
OG0009013	1	1	1	1	4
OG0009014	1	1	2	0	4
OG0009015	1	1	1	1	4
OG0009016	1	1	1	1	4
OG0009017	1	1	1	1	4
OG0009018	1	1	1	1	4
OG0009019	1	1	1	1	4
OG0009020	1	1	1	1	4
OG0009021	1	1	1	1	4
OG0009022	2	1	1	0	4
OG0009023	1	1	1	1	4
OG0009024	1	1	1	1	4
OG0009025	1	1	1	1	4
OG0009026	1	1	1	1	4
OG0009027	1	1	1	1	4
OG0009028	1	1	1	1	4
OG0009029	1	1	1	1	4
OG0009030	1	1	1	1	4
OG0009031	1	1	1	1	4
OG0009032	1	1	1	1	4
OG0009033	1	1	1	1	4
OG0009034	1	1	1	1	4
OG0009035	1	1	1	1	4
OG0009036	1	1	1	1	4
OG0009037	1	1	1	1	4
OG0009038	1	1	1	1	4
OG0009039	1	1	1	1	4
OG0009040	2	1	1	0	4
OG0009041	1	1	1	1	4
OG0009042	1	1	1	1	4
OG0009043	1	0	0	3	4
OG0009044	1	1	1	1	4
OG0009045	1	1	2	0	4
OG0009046	1	1	1	1	4
OG0009047	1	1	1	1	4
OG0009048	1	1	1	1	4
OG0009049	1	1	1	1	4
OG0009050	1	1	1	1	4
OG0009051	1	1	1	1	4
OG0009052	1	1	1	1	4
OG0009053	1	1	1	1	4
OG0009054	1	1	1	1	4
OG0009055	1	1	1	1	4
OG0009056	1	1	1	1	4
OG0009057	1	1	1	1	4
OG0009058	1	1	1	1	4
OG0009059	1	1	1	1	4
OG0009060	1	3	0	0	4
OG0009061	1	1	1	1	4
OG0009062	1	1	1	1	4
OG0009063	1	1	1	1	4
OG0009064	2	0	1	1	4
OG0009065	1	1	1	1	4
OG0009066	1	1	1	1	4
OG0009067	1	1	1	1	4
OG0009068	1	1	1	1	4
OG0009069	1	1	1	1	4
OG0009070	1	1	1	1	4
OG0009071	1	1	1	1	4
OG0009072	1	0	0	3	4
OG0009073	1	1	1	1	4
OG0009074	1	1	1	1	4
OG0009075	1	1	1	1	4
OG0009076	2	1	1	0	4
OG0009077	1	1	1	1	4
OG0009078	1	1	1	1	4
OG0009079	1	1	1	1	4
OG0009080	1	1	1	1	4
OG0009081	1	1	1	1	4
OG0009082	1	1	1	1	4
OG0009083	1	1	1	1	4
OG0009084	1	1	1	1	4
OG0009085	1	1	1	1	4
OG0009086	1	1	1	1	4
OG0009087	1	1	1	1	4
OG0009088	1	1	1	1	4
OG0009089	1	1	1	1	4
OG0009090	1	1	1	1	4
OG0009091	2	1	1	0	4
OG0009092	1	1	1	1	4
OG0009093	1	1	1	1	4
OG0009094	1	1	1	1	4
OG0009095	1	1	1	1	4
OG0009096	1	1	1	1	4
OG0009097	1	1	1	1	4
OG0009098	1	1	1	1	4
OG0009099	1	1	1	1	4
OG0009100	1	1	1	1	4
OG0009101	1	1	1	1	4
OG0009102	1	1	1	1	4
OG0009103	1	1	1	1	4
OG0009104	1	1	1	1	4
OG0009105	1	1	1	1	4
OG0009106	1	1	1	1	4
OG0009107	1	1	1	1	4
OG0009108	1	1	1	1	4
OG0009109	1	1	1	1	4
OG0009110	1	1	1	1	4
OG0009111	1	1	1	1	4
OG0009112	1	1	1	1	4
OG0009113	1	1	1	1	4
OG0009114	1	1	1	1	4
OG0009115	1	1	1	1	4
OG0009116	1	1	1	1	4
OG0009117	1	1	1	1	4
OG0009118	1	1	1	1	4
OG0009119	1	1	1	1	4
OG0009120	1	1	1	1	4
OG0009121	1	1	1	1	4
OG0009122	1	1	1	1	4
OG0009123	1	1	1	1	4
OG0009124	1	1	1	1	4
OG0009125	1	1	1	1	4
OG0009126	1	1	1	1	4
OG0009127	1	1	1	1	4
OG0009128	1	1	1	1	4
OG0009129	1	1	1	1	4
OG0009130	1	1	1	1	4
OG0009131	1	1	2	0	4
OG0009132	1	1	1	1	4
OG0009133	1	1	1	1	4
OG0009134	1	1	1	1	4
OG0009135	1	1	1	1	4
OG0009136	1	1	1	1	4
OG0009137	1	1	1	1	4
OG0009138	1	1	1	1	4
OG0009139	1	1	1	1	4
OG0009140	1	1	1	1	4
OG0009141	1	1	1	1	4
OG0009142	1	1	1	1	4
OG0009143	1	1	1	1	4
OG0009144	1	1	1	1	4
OG0009145	1	1	1	1	4
OG0009146	1	1	1	1	4
OG0009147	1	1	1	1	4
OG0009148	1	1	1	1	4
OG0009149	1	1	1	1	4
OG0009150	1	1	1	1	4
OG0009151	1	1	1	1	4
OG0009152	1	1	1	1	4
OG0009153	1	1	1	1	4
OG0009154	1	1	1	1	4
OG0009155	1	1	1	1	4
OG0009156	1	1	1	1	4
OG0009157	1	1	1	1	4
OG0009158	1	1	1	1	4
OG0009159	1	1	1	1	4
OG0009160	1	1	1	1	4
OG0009161	1	1	1	1	4
OG0009162	1	1	1	1	4
OG0009163	1	1	1	1	4
OG0009164	1	1	1	1	4
OG0009165	1	1	1	1	4
OG0009166	1	1	1	1	4
OG0009167	1	1	1	1	4
OG0009168	1	1	1	1	4
OG0009169	1	1	1	1	4
OG0009170	1	2	1	0	4
OG0009171	1	1	1	1	4
OG0009172	1	1	1	1	4
OG0009173	1	1	1	1	4
OG0009174	1	1	1	1	4
OG0009175	1	1	1	1	4
OG0009176	1	1	1	1	4
OG0009177	1	1	1	1	4
OG0009178	1	1	1	1	4
OG0009179	1	1	1	1	4
OG0009180	1	0	0	3	4
OG0009181	1	1	1	1	4
OG0009182	1	1	1	1	4
OG0009183	1	1	1	1	4
OG0009184	1	2	1	0	4
OG0009185	1	1	1	1	4
OG0009186	1	1	1	1	4
OG0009187	1	1	1	1	4
OG0009188	1	1	1	1	4
OG0009189	1	1	1	1	4
OG0009190	1	1	1	1	4
OG0009191	1	1	1	1	4
OG0009192	1	1	1	1	4
OG0009193	1	1	1	1	4
OG0009194	1	1	1	1	4
OG0009195	1	2	1	0	4
OG0009196	1	1	1	1	4
OG0009197	1	1	1	1	4
OG0009198	1	1	1	1	4
OG0009199	1	1	1	1	4
OG0009200	1	1	1	1	4
OG0009201	1	1	1	1	4
OG0009202	2	1	1	0	4
OG0009203	1	1	1	1	4
OG0009204	1	1	1	1	4
OG0009205	1	1	1	1	4
OG0009206	1	1	1	1	4
OG0009207	1	1	1	1	4
OG0009208	1	1	1	1	4
OG0009209	1	1	1	1	4
OG0009210	1	1	1	1	4
OG0009211	1	1	1	1	4
OG0009212	1	1	1	1	4
OG0009213	1	1	1	1	4
OG0009214	1	1	1	1	4
OG0009215	3	1	0	0	4
OG0009216	1	1	1	1	4
OG0009217	1	1	1	1	4
OG0009218	1	1	1	1	4
OG0009219	1	1	1	1	4
OG0009220	1	1	1	1	4
OG0009221	1	1	1	1	4
OG0009222	1	1	1	1	4
OG0009223	1	1	1	1	4
OG0009224	1	1	1	1	4
OG0009225	1	1	1	1	4
OG0009226	2	1	1	0	4
OG0009227	1	1	1	1	4
OG0009228	1	1	1	1	4
OG0009229	1	1	1	1	4
OG0009230	1	1	1	1	4
OG0009231	1	1	1	1	4
OG0009232	1	1	1	1	4
OG0009233	1	1	1	1	4
OG0009234	1	1	1	1	4
OG0009235	1	1	1	1	4
OG0009236	1	1	1	1	4
OG0009237	1	1	1	1	4
OG0009238	1	1	1	1	4
OG0009239	1	1	1	1	4
OG0009240	1	0	3	0	4
OG0009241	1	1	1	1	4
OG0009242	1	1	1	1	4
OG0009243	1	1	1	1	4
OG0009244	2	0	1	1	4
OG0009245	1	1	1	1	4
OG0009246	1	1	0	2	4
OG0009247	1	1	1	1	4
OG0009248	1	1	1	1	4
OG0009249	1	1	1	1	4
OG0009250	1	1	1	1	4
OG0009251	1	1	1	1	4
OG0009252	1	1	1	1	4
OG0009253	4	0	0	0	4
OG0009254	1	1	1	1	4
OG0009255	1	1	1	1	4
OG0009256	1	1	1	1	4
OG0009257	1	1	1	1	4
OG0009258	1	1	1	1	4
OG0009259	1	1	1	1	4
OG0009260	2	1	1	0	4
OG0009261	1	1	1	1	4
OG0009262	1	1	1	1	4
OG0009263	1	1	1	1	4
OG0009264	1	1	1	1	4
OG0009265	1	1	1	1	4
OG0009266	1	1	1	1	4
OG0009267	1	1	1	1	4
OG0009268	1	1	1	1	4
OG0009269	1	2	1	0	4
OG0009270	2	1	1	0	4
OG0009271	1	1	1	1	4
OG0009272	1	1	1	1	4
OG0009273	1	1	1	1	4
OG0009274	1	1	1	1	4
OG0009275	1	1	1	1	4
OG0009276	1	1	1	1	4
OG0009277	1	1	1	1	4
OG0009278	1	1	1	1	4
OG0009279	1	1	1	1	4
OG0009280	2	2	0	0	4
OG0009281	1	1	1	1	4
OG0009282	1	1	1	1	4
OG0009283	1	1	1	1	4
OG0009284	1	1	1	1	4
OG0009285	1	1	1	1	4
OG0009286	1	1	2	0	4
OG0009287	1	1	1	1	4
OG0009288	1	1	1	1	4
OG0009289	1	1	1	1	4
OG0009290	1	1	1	1	4
OG0009291	1	1	1	1	4
OG0009292	1	1	1	1	4
OG0009293	1	1	1	1	4
OG0009294	1	1	1	1	4
OG0009295	1	1	1	1	4
OG0009296	1	1	1	1	4
OG0009297	1	1	1	1	4
OG0009298	1	1	1	1	4
OG0009299	1	1	1	1	4
OG0009300	1	1	1	1	4
OG0009301	1	1	1	1	4
OG0009302	1	1	1	1	4
OG0009303	1	1	1	1	4
OG0009304	1	1	1	1	4
OG0009305	1	1	1	1	4
OG0009306	1	1	1	1	4
OG0009307	1	1	1	1	4
OG0009308	4	0	0	0	4
OG0009309	1	3	0	0	4
OG0009310	2	1	1	0	4
OG0009311	1	1	1	1	4
OG0009312	1	1	1	1	4
OG0009313	1	1	1	1	4
OG0009314	1	1	1	1	4
OG0009315	1	1	1	1	4
OG0009316	1	1	1	1	4
OG0009317	1	1	2	0	4
OG0009318	1	1	1	1	4
OG0009319	2	1	1	0	4
OG0009320	2	0	1	1	4
OG0009321	1	1	1	1	4
OG0009322	1	1	1	1	4
OG0009323	1	1	1	1	4
OG0009324	1	1	1	1	4
OG0009325	1	1	1	1	4
OG0009326	1	1	2	0	4
OG0009327	1	1	1	1	4
OG0009328	1	1	1	1	4
OG0009329	1	1	1	1	4
OG0009330	1	1	1	1	4
OG0009331	1	1	1	1	4
OG0009332	1	1	1	1	4
OG0009333	1	1	1	1	4
OG0009334	1	1	1	1	4
OG0009335	1	1	1	1	4
OG0009336	1	1	1	1	4
OG0009337	1	1	1	1	4
OG0009338	1	1	1	1	4
OG0009339	1	1	1	1	4
OG0009340	1	1	1	1	4
OG0009341	1	1	1	1	4
OG0009342	1	1	1	1	4
OG0009343	1	1	1	1	4
OG0009344	1	1	1	1	4
OG0009345	1	1	1	1	4
OG0009346	1	1	1	1	4
OG0009347	2	1	1	0	4
OG0009348	1	1	1	1	4
OG0009349	1	1	1	1	4
OG0009350	1	1	1	1	4
OG0009351	1	1	1	1	4
OG0009352	1	1	0	2	4
OG0009353	1	1	1	1	4
OG0009354	1	1	1	1	4
OG0009355	1	1	1	1	4
OG0009356	1	1	2	0	4
OG0009357	2	1	1	0	4
OG0009358	1	1	1	1	4
OG0009359	1	1	1	1	4
OG0009360	1	1	1	1	4
OG0009361	1	1	1	1	4
OG0009362	1	1	1	1	4
OG0009363	1	1	1	1	4
OG0009364	1	1	1	1	4
OG0009365	1	1	1	1	4
OG0009366	1	1	1	1	4
OG0009367	1	1	1	1	4
OG0009368	1	1	1	1	4
OG0009369	1	1	1	1	4
OG0009370	1	1	1	1	4
OG0009371	1	1	1	1	4
OG0009372	1	1	1	1	4
OG0009373	1	1	1	1	4
OG0009374	1	1	1	1	4
OG0009375	1	1	1	1	4
OG0009376	1	1	1	1	4
OG0009377	1	1	1	1	4
OG0009378	1	1	1	1	4
OG0009379	1	1	1	1	4
OG0009380	1	1	1	1	4
OG0009381	1	1	1	1	4
OG0009382	1	1	1	1	4
OG0009383	1	3	0	0	4
OG0009384	1	1	1	1	4
OG0009385	1	1	1	1	4
OG0009386	1	2	1	0	4
OG0009387	1	1	1	1	4
OG0009388	1	1	1	1	4
OG0009389	1	1	1	1	4
OG0009390	1	1	1	1	4
OG0009391	1	1	1	1	4
OG0009392	1	1	1	1	4
OG0009393	1	1	1	1	4
OG0009394	1	1	1	1	4
OG0009395	1	1	1	1	4
OG0009396	1	1	1	1	4
OG0009397	1	1	1	1	4
OG0009398	1	1	1	1	4
OG0009399	1	1	1	1	4
OG0009400	1	1	1	1	4
OG0009401	1	1	2	0	4
OG0009402	1	1	1	1	4
OG0009403	1	1	1	1	4
OG0009404	1	1	1	1	4
OG0009405	1	1	1	1	4
OG0009406	1	1	1	1	4
OG0009407	1	1	1	1	4
OG0009408	1	1	2	0	4
OG0009409	1	1	1	1	4
OG0009410	1	1	1	1	4
OG0009411	1	1	1	1	4
OG0009412	1	3	0	0	4
OG0009413	1	1	1	1	4
OG0009414	1	1	1	1	4
OG0009415	1	1	1	1	4
OG0009416	1	1	1	1	4
OG0009417	1	1	1	1	4
OG0009418	1	1	1	1	4
OG0009419	1	1	1	1	4
OG0009420	4	0	0	0	4
OG0009421	1	1	1	1	4
OG0009422	1	1	1	1	4
OG0009423	1	1	1	1	4
OG0009424	1	1	1	1	4
OG0009425	2	1	1	0	4
OG0009426	1	1	1	1	4
OG0009427	1	1	1	1	4
OG0009428	1	1	1	1	4
OG0009429	1	1	1	1	4
OG0009430	1	1	1	1	4
OG0009431	1	1	1	1	4
OG0009432	1	1	1	1	4
OG0009433	1	3	0	0	4
OG0009434	1	0	0	3	4
OG0009435	1	1	1	1	4
OG0009436	1	1	1	1	4
OG0009437	1	1	1	1	4
OG0009438	1	1	1	1	4
OG0009439	1	1	1	1	4
OG0009440	1	1	1	1	4
OG0009441	1	1	1	1	4
OG0009442	1	1	1	1	4
OG0009443	1	1	1	1	4
OG0009444	1	1	1	1	4
OG0009445	1	1	1	1	4
OG0009446	1	1	1	1	4
OG0009447	1	1	1	1	4
OG0009448	1	1	1	1	4
OG0009449	1	1	1	1	4
OG0009450	1	1	1	1	4
OG0009451	1	1	1	1	4
OG0009452	1	1	1	1	4
OG0009453	1	1	1	1	4
OG0009454	1	1	1	1	4
OG0009455	1	1	1	1	4
OG0009456	1	1	1	1	4
OG0009457	1	1	1	1	4
OG0009458	1	1	1	1	4
OG0009459	1	1	1	1	4
OG0009460	1	1	1	1	4
OG0009461	1	1	1	1	4
OG0009462	1	1	1	1	4
OG0009463	1	1	1	1	4
OG0009464	1	1	1	1	4
OG0009465	1	1	1	1	4
OG0009466	1	1	1	1	4
OG0009467	1	1	1	1	4
OG0009468	1	1	1	1	4
OG0009469	1	1	1	1	4
OG0009470	1	1	1	1	4
OG0009471	1	1	1	1	4
OG0009472	1	1	1	1	4
OG0009473	1	1	1	1	4
OG0009474	1	1	1	1	4
OG0009475	1	1	1	1	4
OG0009476	1	1	1	1	4
OG0009477	1	1	1	1	4
OG0009478	1	1	1	1	4
OG0009479	1	1	1	1	4
OG0009480	1	1	1	1	4
OG0009481	1	1	1	1	4
OG0009482	1	1	1	1	4
OG0009483	1	1	1	1	4
OG0009484	1	1	1	1	4
OG0009485	1	1	1	1	4
OG0009486	1	1	1	1	4
OG0009487	1	1	1	1	4
OG0009488	1	1	2	0	4
OG0009489	1	1	1	1	4
OG0009490	1	1	1	1	4
OG0009491	1	1	1	1	4
OG0009492	1	1	1	1	4
OG0009493	1	1	1	1	4
OG0009494	1	1	1	1	4
OG0009495	1	1	1	1	4
OG0009496	1	1	1	1	4
OG0009497	1	1	1	1	4
OG0009498	1	1	1	1	4
OG0009499	1	1	1	1	4
OG0009500	1	1	1	1	4
OG0009501	1	1	1	1	4
OG0009502	1	1	1	1	4
OG0009503	1	1	1	1	4
OG0009504	1	1	1	1	4
OG0009505	1	1	1	1	4
OG0009506	1	1	1	1	4
OG0009507	1	1	1	1	4
OG0009508	1	1	1	1	4
OG0009509	1	1	1	1	4
OG0009510	1	1	1	1	4
OG0009511	1	1	1	1	4
OG0009512	1	1	1	1	4
OG0009513	1	1	1	1	4
OG0009514	1	1	1	1	4
OG0009515	1	1	1	1	4
OG0009516	1	1	1	1	4
OG0009517	1	1	1	1	4
OG0009518	1	1	1	1	4
OG0009519	1	1	1	1	4
OG0009520	1	1	1	1	4
OG0009521	1	1	1	1	4
OG0009522	1	1	1	1	4
OG0009523	1	1	1	1	4
OG0009524	1	1	1	1	4
OG0009525	1	1	1	1	4
OG0009526	1	1	1	1	4
OG0009527	1	1	1	1	4
OG0009528	1	1	1	1	4
OG0009529	1	1	1	1	4
OG0009530	1	1	1	1	4
OG0009531	1	1	1	1	4
OG0009532	1	1	1	1	4
OG0009533	1	1	1	1	4
OG0009534	1	1	1	1	4
OG0009535	1	1	1	1	4
OG0009536	1	1	1	1	4
OG0009537	1	1	1	1	4
OG0009538	1	1	1	1	4
OG0009539	1	1	1	1	4
OG0009540	1	1	1	1	4
OG0009541	1	1	1	1	4
OG0009542	1	1	1	1	4
OG0009543	1	1	1	1	4
OG0009544	1	1	1	1	4
OG0009545	1	1	1	1	4
OG0009546	1	1	1	1	4
OG0009547	1	1	1	1	4
OG0009548	1	2	0	1	4
OG0009549	1	1	1	1	4
OG0009550	1	1	1	1	4
OG0009551	1	1	1	1	4
OG0009552	2	2	0	0	4
OG0009553	1	1	1	1	4
OG0009554	1	1	1	1	4
OG0009555	1	1	1	1	4
OG0009556	1	1	1	1	4
OG0009557	1	1	1	1	4
OG0009558	1	1	1	1	4
OG0009559	1	1	1	1	4
OG0009560	1	1	1	1	4
OG0009561	1	1	1	1	4
OG0009562	1	1	1	1	4
OG0009563	1	1	1	1	4
OG0009564	1	1	1	1	4
OG0009565	1	1	1	1	4
OG0009566	1	1	1	1	4
OG0009567	1	1	1	1	4
OG0009568	1	1	1	1	4
OG0009569	1	1	1	1	4
OG0009570	1	1	1	1	4
OG0009571	1	1	1	1	4
OG0009572	1	1	1	1	4
OG0009573	1	1	1	1	4
OG0009574	1	1	1	1	4
OG0009575	1	1	1	1	4
OG0009576	1	1	1	1	4
OG0009577	1	1	1	1	4
OG0009578	1	1	1	1	4
OG0009579	1	1	2	0	4
OG0009580	2	1	1	0	4
OG0009581	1	1	2	0	4
OG0009582	1	1	1	1	4
OG0009583	1	1	1	1	4
OG0009584	2	1	1	0	4
OG0009585	1	1	1	1	4
OG0009586	1	1	1	1	4
OG0009587	1	1	1	1	4
OG0009588	1	1	1	1	4
OG0009589	1	1	1	1	4
OG0009590	1	1	1	1	4
OG0009591	1	1	1	1	4
OG0009592	1	1	1	1	4
OG0009593	1	1	1	1	4
OG0009594	1	1	1	1	4
OG0009595	1	1	1	1	4
OG0009596	1	1	1	1	4
OG0009597	1	1	1	1	4
OG0009598	1	1	1	1	4
OG0009599	1	1	1	1	4
OG0009600	1	1	1	1	4
OG0009601	1	1	1	1	4
OG0009602	1	1	1	1	4
OG0009603	1	1	1	1	4
OG0009604	1	1	1	1	4
OG0009605	1	1	1	1	4
OG0009606	1	1	1	1	4
OG0009607	1	1	1	1	4
OG0009608	1	1	1	1	4
OG0009609	1	1	1	1	4
OG0009610	1	1	1	1	4
OG0009611	1	1	1	1	4
OG0009612	1	1	1	1	4
OG0009613	1	1	1	1	4
OG0009614	1	1	1	1	4
OG0009615	1	1	1	1	4
OG0009616	1	1	1	1	4
OG0009617	1	1	1	1	4
OG0009618	1	1	1	1	4
OG0009619	1	1	1	1	4
OG0009620	1	1	1	1	4
OG0009621	1	1	1	1	4
OG0009622	1	1	1	1	4
OG0009623	1	1	1	1	4
OG0009624	1	1	1	1	4
OG0009625	1	1	1	1	4
OG0009626	1	1	1	1	4
OG0009627	1	1	1	1	4
OG0009628	1	1	1	1	4
OG0009629	1	1	0	2	4
OG0009630	1	1	1	1	4
OG0009631	1	1	1	1	4
OG0009632	1	1	1	1	4
OG0009633	1	1	1	1	4
OG0009634	1	1	1	1	4
OG0009635	1	1	1	1	4
OG0009636	1	1	1	1	4
OG0009637	1	1	1	1	4
OG0009638	1	1	1	1	4
OG0009639	1	1	1	1	4
OG0009640	1	1	1	1	4
OG0009641	1	1	1	1	4
OG0009642	1	1	1	1	4
OG0009643	1	1	1	1	4
OG0009644	1	1	1	1	4
OG0009645	1	1	1	1	4
OG0009646	1	1	1	1	4
OG0009647	1	1	1	1	4
OG0009648	1	1	1	1	4
OG0009649	1	1	1	1	4
OG0009650	1	1	1	1	4
OG0009651	1	1	1	1	4
OG0009652	1	1	1	1	4
OG0009653	1	1	1	1	4
OG0009654	1	1	1	1	4
OG0009655	1	1	1	1	4
OG0009656	1	1	1	1	4
OG0009657	1	1	1	1	4
OG0009658	1	1	1	1	4
OG0009659	1	1	1	1	4
OG0009660	1	1	1	1	4
OG0009661	1	1	1	1	4
OG0009662	1	1	1	1	4
OG0009663	1	1	1	1	4
OG0009664	1	1	1	1	4
OG0009665	1	1	1	1	4
OG0009666	1	1	1	1	4
OG0009667	1	1	1	1	4
OG0009668	1	1	1	1	4
OG0009669	1	1	1	1	4
OG0009670	1	1	1	1	4
OG0009671	1	1	1	1	4
OG0009672	2	1	1	0	4
OG0009673	1	1	1	1	4
OG0009674	2	1	1	0	4
OG0009675	1	1	1	1	4
OG0009676	1	1	1	1	4
OG0009677	1	1	1	1	4
OG0009678	1	1	1	1	4
OG0009679	1	1	1	1	4
OG0009680	1	1	1	1	4
OG0009681	1	1	1	1	4
OG0009682	2	0	2	0	4
OG0009683	1	1	1	1	4
OG0009684	1	1	1	1	4
OG0009685	1	1	1	1	4
OG0009686	1	1	1	1	4
OG0009687	1	1	1	1	4
OG0009688	1	1	1	1	4
OG0009689	1	1	1	1	4
OG0009690	1	1	1	1	4
OG0009691	3	1	0	0	4
OG0009692	2	1	1	0	4
OG0009693	1	1	1	1	4
OG0009694	1	1	1	1	4
OG0009695	1	1	1	1	4
OG0009696	1	1	1	1	4
OG0009697	1	1	1	1	4
OG0009698	1	1	1	1	4
OG0009699	1	1	1	1	4
OG0009700	1	1	1	1	4
OG0009701	1	1	1	1	4
OG0009702	1	1	1	1	4
OG0009703	1	1	1	1	4
OG0009704	1	1	1	1	4
OG0009705	1	1	1	1	4
OG0009706	1	1	1	1	4
OG0009707	1	1	2	0	4
OG0009708	1	1	1	1	4
OG0009709	1	1	1	1	4
OG0009710	1	3	0	0	4
OG0009711	1	1	1	1	4
OG0009712	1	1	1	1	4
OG0009713	1	1	1	1	4
OG0009714	1	1	1	1	4
OG0009715	1	1	1	1	4
OG0009716	1	1	1	1	4
OG0009717	1	1	1	1	4
OG0009718	1	1	1	1	4
OG0009719	1	1	1	1	4
OG0009720	1	1	1	1	4
OG0009721	1	1	1	1	4
OG0009722	1	1	1	1	4
OG0009723	1	1	1	1	4
OG0009724	1	2	1	0	4
OG0009725	1	1	1	1	4
OG0009726	1	1	1	1	4
OG0009727	1	1	1	1	4
OG0009728	1	1	1	1	4
OG0009729	1	1	1	1	4
OG0009730	1	1	1	1	4
OG0009731	1	1	1	1	4
OG0009732	1	1	1	1	4
OG0009733	1	1	1	1	4
OG0009734	1	1	1	1	4
OG0009735	1	1	1	1	4
OG0009736	1	1	1	1	4
OG0009737	1	1	1	1	4
OG0009738	1	1	1	1	4
OG0009739	1	1	1	1	4
OG0009740	1	1	1	1	4
OG0009741	1	1	1	1	4
OG0009742	1	1	2	0	4
OG0009743	1	1	1	1	4
OG0009744	1	1	1	1	4
OG0009745	1	1	1	1	4
OG0009746	1	1	1	1	4
OG0009747	1	1	1	1	4
OG0009748	1	1	1	1	4
OG0009749	1	1	1	1	4
OG0009750	1	1	1	1	4
OG0009751	1	1	1	1	4
OG0009752	1	1	1	1	4
OG0009753	1	1	1	1	4
OG0009754	1	1	1	1	4
OG0009755	1	1	1	1	4
OG0009756	1	1	1	1	4
OG0009757	1	1	1	1	4
OG0009758	1	1	1	1	4
OG0009759	1	1	1	1	4
OG0009760	1	1	1	1	4
OG0009761	1	1	1	1	4
OG0009762	1	1	1	1	4
OG0009763	1	1	1	1	4
OG0009764	1	1	1	1	4
OG0009765	1	1	1	1	4
OG0009766	1	1	1	1	4
OG0009767	1	3	0	0	4
OG0009768	1	1	1	1	4
OG0009769	1	1	1	1	4
OG0009770	1	1	1	1	4
OG0009771	1	1	1	1	4
OG0009772	1	1	1	1	4
OG0009773	1	1	1	1	4
OG0009774	1	1	1	1	4
OG0009775	1	1	1	1	4
OG0009776	1	1	1	1	4
OG0009777	1	1	2	0	4
OG0009778	1	1	1	1	4
OG0009779	1	1	1	1	4
OG0009780	1	1	1	1	4
OG0009781	1	1	1	1	4
OG0009782	1	1	1	1	4
OG0009783	1	1	1	1	4
OG0009784	1	1	1	1	4
OG0009785	1	1	1	1	4
OG0009786	1	1	1	1	4
OG0009787	1	1	1	1	4
OG0009788	1	1	1	1	4
OG0009789	1	1	1	1	4
OG0009790	1	1	1	1	4
OG0009791	1	1	1	1	4
OG0009792	1	1	1	1	4
OG0009793	1	1	1	1	4
OG0009794	1	1	1	1	4
OG0009795	1	1	1	1	4
OG0009796	1	1	1	1	4
OG0009797	1	1	1	1	4
OG0009798	1	1	1	1	4
OG0009799	1	1	1	1	4
OG0009800	1	1	1	1	4
OG0009801	1	1	1	1	4
OG0009802	1	1	1	1	4
OG0009803	1	1	1	1	4
OG0009804	1	1	1	1	4
OG0009805	1	1	1	1	4
OG0009806	1	1	1	1	4
OG0009807	1	1	1	1	4
OG0009808	1	1	1	1	4
OG0009809	1	1	1	1	4
OG0009810	1	1	1	1	4
OG0009811	1	1	1	1	4
OG0009812	1	1	1	1	4
OG0009813	1	0	3	0	4
OG0009814	1	1	1	1	4
OG0009815	1	1	1	1	4
OG0009816	1	1	1	1	4
OG0009817	1	1	1	1	4
OG0009818	1	1	1	1	4
OG0009819	1	1	1	1	4
OG0009820	1	1	1	1	4
OG0009821	1	1	1	1	4
OG0009822	1	1	1	1	4
OG0009823	1	1	1	1	4
OG0009824	1	1	1	1	4
OG0009825	1	1	1	1	4
OG0009826	1	1	2	0	4
OG0009827	1	1	2	0	4
OG0009828	1	1	1	1	4
OG0009829	1	1	1	1	4
OG0009830	1	1	1	1	4
OG0009831	1	2	1	0	4
OG0009832	1	1	1	1	4
OG0009833	1	1	1	1	4
OG0009834	1	1	1	1	4
OG0009835	1	1	1	1	4
OG0009836	1	1	1	1	4
OG0009837	1	1	1	1	4
OG0009838	1	1	1	1	4
OG0009839	1	1	1	1	4
OG0009840	1	1	1	1	4
OG0009841	1	1	1	1	4
OG0009842	1	1	1	1	4
OG0009843	1	1	1	1	4
OG0009844	1	1	1	1	4
OG0009845	1	1	1	1	4
OG0009846	1	1	1	1	4
OG0009847	1	1	1	1	4
OG0009848	1	1	1	1	4
OG0009849	1	1	1	1	4
OG0009850	1	1	1	1	4
OG0009851	1	1	1	1	4
OG0009852	1	1	1	1	4
OG0009853	1	1	1	1	4
OG0009854	1	1	1	1	4
OG0009855	2	1	0	1	4
OG0009856	1	1	1	1	4
OG0009857	1	1	1	1	4
OG0009858	1	1	1	1	4
OG0009859	1	1	1	1	4
OG0009860	1	1	1	1	4
OG0009861	1	1	1	1	4
OG0009862	1	1	1	1	4
OG0009863	1	1	1	1	4
OG0009864	1	1	1	1	4
OG0009865	1	1	1	1	4
OG0009866	1	1	1	1	4
OG0009867	1	1	1	1	4
OG0009868	1	1	1	1	4
OG0009869	2	1	1	0	4
OG0009870	1	1	1	1	4
OG0009871	1	1	1	1	4
OG0009872	1	1	1	1	4
OG0009873	1	1	1	1	4
OG0009874	1	1	1	1	4
OG0009875	1	1	1	1	4
OG0009876	1	1	1	1	4
OG0009877	1	1	1	1	4
OG0009878	1	1	1	1	4
OG0009879	1	1	1	1	4
OG0009880	1	1	1	1	4
OG0009881	1	1	1	1	4
OG0009882	1	1	1	1	4
OG0009883	1	1	1	1	4
OG0009884	1	1	1	1	4
OG0009885	1	1	1	1	4
OG0009886	1	1	1	1	4
OG0009887	1	1	1	1	4
OG0009888	1	1	1	1	4
OG0009889	1	1	1	1	4
OG0009890	1	1	1	1	4
OG0009891	1	1	1	1	4
OG0009892	1	1	1	1	4
OG0009893	1	1	1	1	4
OG0009894	1	1	1	1	4
OG0009895	1	3	0	0	4
OG0009896	1	1	1	1	4
OG0009897	1	1	1	1	4
OG0009898	1	1	1	1	4
OG0009899	1	1	1	1	4
OG0009900	4	0	0	0	4
OG0009901	1	1	1	1	4
OG0009902	1	1	1	1	4
OG0009903	1	1	1	1	4
OG0009904	1	1	1	1	4
OG0009905	1	2	1	0	4
OG0009906	1	1	1	1	4
OG0009907	1	1	1	1	4
OG0009908	1	1	1	1	4
OG0009909	1	1	1	1	4
OG0009910	1	1	1	1	4
OG0009911	1	1	1	1	4
OG0009912	1	1	1	1	4
OG0009913	1	1	1	1	4
OG0009914	1	1	2	0	4
OG0009915	1	1	1	1	4
OG0009916	1	1	1	1	4
OG0009917	1	1	1	1	4
OG0009918	1	1	1	1	4
OG0009919	1	1	1	1	4
OG0009920	1	1	1	1	4
OG0009921	1	1	1	1	4
OG0009922	1	1	1	1	4
OG0009923	1	1	1	1	4
OG0009924	2	1	1	0	4
OG0009925	1	1	1	1	4
OG0009926	1	1	1	1	4
OG0009927	1	1	1	1	4
OG0009928	1	1	2	0	4
OG0009929	1	1	1	1	4
OG0009930	1	1	1	1	4
OG0009931	1	1	1	1	4
OG0009932	1	1	1	1	4
OG0009933	2	1	1	0	4
OG0009934	2	0	0	2	4
OG0009935	1	1	1	1	4
OG0009936	1	1	1	1	4
OG0009937	1	1	1	1	4
OG0009938	1	3	0	0	4
OG0009939	1	1	1	1	4
OG0009940	1	1	1	1	4
OG0009941	1	1	1	1	4
OG0009942	1	1	1	1	4
OG0009943	1	1	1	1	4
OG0009944	1	1	1	1	4
OG0009945	1	1	1	1	4
OG0009946	1	1	1	1	4
OG0009947	1	1	1	1	4
OG0009948	1	1	1	1	4
OG0009949	1	1	1	1	4
OG0009950	1	1	1	1	4
OG0009951	1	1	1	1	4
OG0009952	1	1	1	1	4
OG0009953	1	1	1	1	4
OG0009954	1	1	1	1	4
OG0009955	4	0	0	0	4
OG0009956	1	1	1	1	4
OG0009957	1	1	1	1	4
OG0009958	1	1	1	1	4
OG0009959	1	1	1	1	4
OG0009960	1	1	1	1	4
OG0009961	1	1	1	1	4
OG0009962	1	1	1	1	4
OG0009963	1	0	0	3	4
OG0009964	1	1	1	1	4
OG0009965	1	1	1	1	4
OG0009966	1	1	1	1	4
OG0009967	1	1	1	1	4
OG0009968	1	1	1	1	4
OG0009969	1	2	1	0	4
OG0009970	1	1	1	1	4
OG0009971	1	1	1	1	4
OG0009972	1	1	1	1	4
OG0009973	1	1	1	1	4
OG0009974	1	1	1	1	4
OG0009975	1	1	1	1	4
OG0009976	1	1	1	1	4
OG0009977	1	1	2	0	4
OG0009978	1	1	1	1	4
OG0009979	1	1	1	1	4
OG0009980	1	1	1	1	4
OG0009981	1	1	1	1	4
OG0009982	1	1	1	1	4
OG0009983	1	1	1	1	4
OG0009984	1	1	1	1	4
OG0009985	1	1	1	1	4
OG0009986	1	1	1	1	4
OG0009987	1	1	1	1	4
OG0009988	1	1	1	1	4
OG0009989	1	1	1	1	4
OG0009990	1	1	1	1	4
OG0009991	1	1	1	1	4
OG0009992	1	1	1	1	4
OG0009993	1	1	1	1	4
OG0009994	1	1	1	1	4
OG0009995	1	1	1	1	4
OG0009996	1	1	1	1	4
OG0009997	1	1	1	1	4
OG0009998	1	1	1	1	4
OG0009999	1	1	1	1	4
OG0010000	1	1	1	1	4
OG0010001	1	1	1	1	4
OG0010002	1	1	1	1	4
OG0010003	1	1	1	1	4
OG0010004	1	1	1	1	4
OG0010005	1	1	1	1	4
OG0010006	1	1	1	1	4
OG0010007	1	1	1	1	4
OG0010008	1	0	0	3	4
OG0010009	1	1	1	1	4
OG0010010	1	1	1	1	4
OG0010011	1	1	1	1	4
OG0010012	1	1	1	1	4
OG0010013	1	1	2	0	4
OG0010014	1	1	1	1	4
OG0010015	1	1	1	1	4
OG0010016	1	1	1	1	4
OG0010017	1	1	1	1	4
OG0010018	1	1	1	1	4
OG0010019	1	1	1	1	4
OG0010020	1	3	0	0	4
OG0010021	1	1	1	1	4
OG0010022	1	1	1	1	4
OG0010023	1	1	1	1	4
OG0010024	1	1	1	1	4
OG0010025	1	1	1	1	4
OG0010026	1	1	1	1	4
OG0010027	2	1	1	0	4
OG0010028	1	1	1	1	4
OG0010029	1	1	2	0	4
OG0010030	1	1	1	1	4
OG0010031	1	1	1	1	4
OG0010032	1	1	1	1	4
OG0010033	1	1	1	1	4
OG0010034	1	1	1	1	4
OG0010035	1	1	1	1	4
OG0010036	1	1	1	1	4
OG0010037	1	1	1	1	4
OG0010038	1	1	1	1	4
OG0010039	1	1	1	1	4
OG0010040	1	1	1	1	4
OG0010041	1	1	1	1	4
OG0010042	1	1	1	1	4
OG0010043	1	1	1	1	4
OG0010044	1	1	1	1	4
OG0010045	1	1	1	1	4
OG0010046	1	1	1	1	4
OG0010047	4	0	0	0	4
OG0010048	1	1	1	1	4
OG0010049	1	1	1	1	4
OG0010050	1	1	1	1	4
OG0010051	1	1	1	1	4
OG0010052	1	1	1	1	4
OG0010053	1	1	1	1	4
OG0010054	1	1	1	1	4
OG0010055	1	1	1	1	4
OG0010056	1	1	1	1	4
OG0010057	1	1	1	1	4
OG0010058	1	1	1	1	4
OG0010059	1	1	1	1	4
OG0010060	1	1	1	1	4
OG0010061	1	1	1	1	4
OG0010062	1	1	1	1	4
OG0010063	1	1	1	1	4
OG0010064	1	1	1	1	4
OG0010065	1	1	1	1	4
OG0010066	1	1	1	1	4
OG0010067	1	1	1	1	4
OG0010068	1	1	1	1	4
OG0010069	1	1	1	1	4
OG0010070	1	1	1	1	4
OG0010071	1	1	1	1	4
OG0010072	1	1	1	1	4
OG0010073	1	1	1	1	4
OG0010074	1	1	1	1	4
OG0010075	1	1	1	1	4
OG0010076	1	1	1	1	4
OG0010077	1	1	1	1	4
OG0010078	1	1	1	1	4
OG0010079	1	1	1	1	4
OG0010080	1	1	2	0	4
OG0010081	1	1	1	1	4
OG0010082	1	1	1	1	4
OG0010083	1	1	1	1	4
OG0010084	1	1	1	1	4
OG0010085	1	1	1	1	4
OG0010086	1	1	1	1	4
OG0010087	1	1	1	1	4
OG0010088	1	1	1	1	4
OG0010089	1	1	1	1	4
OG0010090	1	1	1	1	4
OG0010091	1	1	1	1	4
OG0010092	1	1	1	1	4
OG0010093	1	1	1	1	4
OG0010094	1	1	1	1	4
OG0010095	1	1	1	1	4
OG0010096	1	1	1	1	4
OG0010097	1	1	1	1	4
OG0010098	1	1	1	1	4
OG0010099	1	1	1	1	4
OG0010100	1	1	1	1	4
OG0010101	1	1	1	1	4
OG0010102	1	1	1	1	4
OG0010103	1	1	1	1	4
OG0010104	1	1	1	1	4
OG0010105	1	2	0	1	4
OG0010106	1	1	1	1	4
OG0010107	1	1	1	1	4
OG0010108	1	1	1	1	4
OG0010109	2	1	1	0	4
OG0010110	1	1	1	1	4
OG0010111	1	1	1	1	4
OG0010112	1	1	1	1	4
OG0010113	1	2	1	0	4
OG0010114	1	1	1	1	4
OG0010115	1	1	1	1	4
OG0010116	1	1	1	1	4
OG0010117	1	1	1	1	4
OG0010118	1	1	1	1	4
OG0010119	1	1	1	1	4
OG0010120	1	1	1	1	4
OG0010121	2	1	1	0	4
OG0010122	1	1	1	1	4
OG0010123	1	1	1	1	4
OG0010124	1	1	1	1	4
OG0010125	1	1	1	1	4
OG0010126	1	1	1	1	4
OG0010127	1	1	1	1	4
OG0010128	1	1	1	1	4
OG0010129	1	1	1	1	4
OG0010130	1	1	1	1	4
OG0010131	1	1	1	1	4
OG0010132	1	1	1	1	4
OG0010133	1	1	1	1	4
OG0010134	1	1	1	1	4
OG0010135	1	1	1	1	4
OG0010136	1	1	1	1	4
OG0010137	1	1	1	1	4
OG0010138	1	1	1	1	4
OG0010139	1	1	1	1	4
OG0010140	1	1	1	1	4
OG0010141	1	1	1	1	4
OG0010142	1	1	1	1	4
OG0010143	1	1	1	1	4
OG0010144	1	1	1	1	4
OG0010145	1	1	1	1	4
OG0010146	1	1	1	1	4
OG0010147	1	1	1	1	4
OG0010148	1	1	1	1	4
OG0010149	1	1	1	1	4
OG0010150	1	1	1	1	4
OG0010151	1	1	1	1	4
OG0010152	1	1	1	1	4
OG0010153	1	1	1	1	4
OG0010154	1	1	1	1	4
OG0010155	1	1	1	1	4
OG0010156	1	1	1	1	4
OG0010157	1	1	1	1	4
OG0010158	1	1	1	1	4
OG0010159	1	1	1	1	4
OG0010160	1	1	2	0	4
OG0010161	1	1	1	1	4
OG0010162	1	1	1	1	4
OG0010163	1	1	1	1	4
OG0010164	1	1	1	1	4
OG0010165	1	1	1	1	4
OG0010166	1	1	1	1	4
OG0010167	1	1	1	1	4
OG0010168	1	1	1	1	4
OG0010169	1	1	1	1	4
OG0010170	1	1	1	1	4
OG0010171	1	1	1	1	4
OG0010172	1	1	1	1	4
OG0010173	1	1	1	1	4
OG0010174	1	1	1	1	4
OG0010175	1	1	1	1	4
OG0010176	1	1	1	1	4
OG0010177	1	1	1	1	4
OG0010178	1	1	1	1	4
OG0010179	1	1	1	1	4
OG0010180	1	1	1	1	4
OG0010181	1	1	1	1	4
OG0010182	1	1	1	1	4
OG0010183	1	1	1	1	4
OG0010184	1	2	0	1	4
OG0010185	1	1	1	1	4
OG0010186	1	1	1	1	4
OG0010187	1	1	1	1	4
OG0010188	2	1	1	0	4
OG0010189	1	1	1	1	4
OG0010190	1	1	1	1	4
OG0010191	1	1	1	1	4
OG0010192	1	1	1	1	4
OG0010193	1	1	1	1	4
OG0010194	1	1	1	1	4
OG0010195	2	1	1	0	4
OG0010196	1	1	1	1	4
OG0010197	1	1	1	1	4
OG0010198	1	1	1	1	4
OG0010199	1	1	1	1	4
OG0010200	1	1	1	1	4
OG0010201	1	1	1	1	4
OG0010202	1	1	1	1	4
OG0010203	1	1	1	1	4
OG0010204	1	1	1	1	4
OG0010205	1	1	1	1	4
OG0010206	1	1	1	1	4
OG0010207	1	1	1	1	4
OG0010208	1	1	1	1	4
OG0010209	1	1	1	1	4
OG0010210	1	1	2	0	4
OG0010211	1	1	1	1	4
OG0010212	1	1	2	0	4
OG0010213	2	1	0	1	4
OG0010214	1	1	1	1	4
OG0010215	1	1	1	1	4
OG0010216	1	1	1	1	4
OG0010217	1	1	1	1	4
OG0010218	1	1	1	1	4
OG0010219	1	1	1	1	4
OG0010220	1	1	1	1	4
OG0010221	1	1	1	1	4
OG0010222	1	1	1	1	4
OG0010223	1	1	1	1	4
OG0010224	1	1	1	1	4
OG0010225	1	1	1	1	4
OG0010226	1	1	1	1	4
OG0010227	1	1	1	1	4
OG0010228	1	1	2	0	4
OG0010229	1	1	1	1	4
OG0010230	2	1	1	0	4
OG0010231	1	1	1	1	4
OG0010232	1	1	1	1	4
OG0010233	1	1	1	1	4
OG0010234	1	1	1	1	4
OG0010235	1	1	1	1	4
OG0010236	1	1	1	1	4
OG0010237	1	1	1	1	4
OG0010238	1	2	1	0	4
OG0010239	1	1	1	1	4
OG0010240	1	1	1	1	4
OG0010241	1	1	1	1	4
OG0010242	1	1	1	1	4
OG0010243	1	1	1	1	4
OG0010244	1	1	1	1	4
OG0010245	2	1	1	0	4
OG0010246	1	1	1	1	4
OG0010247	1	1	1	1	4
OG0010248	1	1	1	1	4
OG0010249	1	1	1	1	4
OG0010250	1	1	1	1	4
OG0010251	1	1	1	1	4
OG0010252	1	1	1	1	4
OG0010253	1	1	1	1	4
OG0010254	1	1	1	1	4
OG0010255	1	2	0	1	4
OG0010256	1	1	1	1	4
OG0010257	1	1	1	1	4
OG0010258	1	1	1	1	4
OG0010259	1	1	1	1	4
OG0010260	1	1	1	1	4
OG0010261	1	1	1	1	4
OG0010262	1	1	1	1	4
OG0010263	1	1	1	1	4
OG0010264	1	1	1	1	4
OG0010265	1	1	1	1	4
OG0010266	1	1	1	1	4
OG0010267	1	1	1	1	4
OG0010268	1	1	1	1	4
OG0010269	1	1	1	1	4
OG0010270	1	1	2	0	4
OG0010271	1	1	1	1	4
OG0010272	1	1	1	1	4
OG0010273	1	0	2	1	4
OG0010274	1	1	1	1	4
OG0010275	1	1	1	1	4
OG0010276	1	1	1	1	4
OG0010277	1	1	1	1	4
OG0010278	1	1	1	1	4
OG0010279	1	1	1	1	4
OG0010280	1	1	1	1	4
OG0010281	1	1	1	1	4
OG0010282	1	1	1	1	4
OG0010283	1	1	1	1	4
OG0010284	1	1	1	1	4
OG0010285	1	1	0	2	4
OG0010286	1	1	1	1	4
OG0010287	1	1	1	1	4
OG0010288	1	1	2	0	4
OG0010289	1	1	1	1	4
OG0010290	1	1	1	1	4
OG0010291	1	1	1	1	4
OG0010292	1	1	1	1	4
OG0010293	1	1	1	1	4
OG0010294	1	0	3	0	4
OG0010295	1	1	1	1	4
OG0010296	1	1	1	1	4
OG0010297	1	1	1	1	4
OG0010298	1	1	2	0	4
OG0010299	1	1	1	1	4
OG0010300	1	1	1	1	4
OG0010301	1	1	1	1	4
OG0010302	1	1	1	1	4
OG0010303	1	1	1	1	4
OG0010304	1	1	1	1	4
OG0010305	1	1	1	1	4
OG0010306	1	1	1	1	4
OG0010307	1	1	1	1	4
OG0010308	1	1	1	1	4
OG0010309	1	1	1	1	4
OG0010310	1	1	2	0	4
OG0010311	1	1	1	1	4
OG0010312	1	1	1	1	4
OG0010313	1	1	1	1	4
OG0010314	1	1	1	1	4
OG0010315	1	1	1	1	4
OG0010316	1	1	1	1	4
OG0010317	1	1	1	1	4
OG0010318	1	1	1	1	4
OG0010319	1	1	1	1	4
OG0010320	1	1	1	1	4
OG0010321	1	1	1	1	4
OG0010322	1	1	1	1	4
OG0010323	1	1	2	0	4
OG0010324	1	1	1	1	4
OG0010325	1	1	1	1	4
OG0010326	1	1	1	1	4
OG0010327	1	1	1	1	4
OG0010328	1	1	1	1	4
OG0010329	1	1	1	1	4
OG0010330	1	1	2	0	4
OG0010331	1	1	1	1	4
OG0010332	1	1	1	1	4
OG0010333	1	1	1	1	4
OG0010334	1	1	1	1	4
OG0010335	1	1	1	1	4
OG0010336	1	1	1	1	4
OG0010337	1	1	1	1	4
OG0010338	1	1	1	1	4
OG0010339	1	1	1	1	4
OG0010340	1	1	1	1	4
OG0010341	1	1	1	1	4
OG0010342	1	1	1	1	4
OG0010343	1	1	1	1	4
OG0010344	4	0	0	0	4
OG0010345	1	1	1	1	4
OG0010346	1	1	1	1	4
OG0010347	1	1	1	1	4
OG0010348	1	1	1	1	4
OG0010349	1	1	1	1	4
OG0010350	1	1	1	1	4
OG0010351	1	1	1	1	4
OG0010352	1	1	1	1	4
OG0010353	3	0	0	1	4
OG0010354	1	1	1	1	4
OG0010355	3	1	0	0	4
OG0010356	1	1	1	1	4
OG0010357	1	1	1	1	4
OG0010358	1	1	1	1	4
OG0010359	1	1	1	1	4
OG0010360	1	1	1	1	4
OG0010361	1	1	1	1	4
OG0010362	1	1	2	0	4
OG0010363	1	1	1	1	4
OG0010364	1	1	1	1	4
OG0010365	1	1	1	1	4
OG0010366	1	1	1	1	4
OG0010367	1	1	1	1	4
OG0010368	1	1	1	1	4
OG0010369	1	1	1	1	4
OG0010370	2	1	1	0	4
OG0010371	1	1	1	1	4
OG0010372	1	1	1	1	4
OG0010373	1	1	1	1	4
OG0010374	1	1	1	1	4
OG0010375	1	1	1	1	4
OG0010376	1	1	1	1	4
OG0010377	1	1	1	1	4
OG0010378	1	1	1	1	4
OG0010379	1	1	1	1	4
OG0010380	1	1	1	1	4
OG0010381	1	1	1	1	4
OG0010382	1	2	1	0	4
OG0010383	1	1	1	1	4
OG0010384	1	1	1	1	4
OG0010385	1	1	1	1	4
OG0010386	1	1	1	1	4
OG0010387	1	1	1	1	4
OG0010388	1	0	3	0	4
OG0010389	1	1	2	0	4
OG0010390	1	1	1	1	4
OG0010391	1	1	2	0	4
OG0010392	1	1	1	1	4
OG0010393	1	1	1	1	4
OG0010394	1	1	2	0	4
OG0010395	1	1	1	1	4
OG0010396	1	0	3	0	4
OG0010397	1	1	1	1	4
OG0010398	1	1	1	1	4
OG0010399	1	0	3	0	4
OG0010400	1	1	2	0	4
OG0010401	1	1	1	1	4
OG0010402	1	1	1	1	4
OG0010403	1	1	1	1	4
OG0010404	1	1	1	1	4
OG0010405	1	1	1	1	4
OG0010406	1	1	1	1	4
OG0010407	1	1	1	1	4
OG0010408	1	1	1	1	4
OG0010409	1	1	1	1	4
OG0010410	1	1	1	1	4
OG0010411	1	1	1	1	4
OG0010412	1	1	1	1	4
OG0010413	1	1	1	1	4
OG0010414	1	1	1	1	4
OG0010415	1	1	1	1	4
OG0010416	1	1	1	1	4
OG0010417	1	1	1	1	4
OG0010418	1	1	1	1	4
OG0010419	1	1	1	1	4
OG0010420	1	1	1	1	4
OG0010421	1	1	1	1	4
OG0010422	1	2	1	0	4
OG0010423	1	1	2	0	4
OG0010424	1	1	1	1	4
OG0010425	1	1	1	1	4
OG0010426	1	1	1	1	4
OG0010427	2	1	1	0	4
OG0010428	1	2	1	0	4
OG0010429	1	1	1	1	4
OG0010430	1	1	1	1	4
OG0010431	1	1	1	1	4
OG0010432	1	1	1	1	4
OG0010433	1	1	1	1	4
OG0010434	1	1	1	1	4
OG0010435	1	1	1	1	4
OG0010436	1	1	1	1	4
OG0010437	1	1	1	1	4
OG0010438	1	1	1	1	4
OG0010439	1	1	1	1	4
OG0010440	1	1	1	1	4
OG0010441	1	1	1	1	4
OG0010442	1	1	1	1	4
OG0010443	1	3	0	0	4
OG0010444	2	1	1	0	4
OG0010445	1	1	1	1	4
OG0010446	1	1	1	1	4
OG0010447	1	1	1	1	4
OG0010448	1	1	1	1	4
OG0010449	1	0	3	0	4
OG0010450	1	1	1	1	4
OG0010451	1	1	1	1	4
OG0010452	1	1	1	1	4
OG0010453	1	2	1	0	4
OG0010454	1	1	2	0	4
OG0010455	1	1	1	1	4
OG0010456	1	1	1	1	4
OG0010457	1	1	1	1	4
OG0010458	1	1	1	1	4
OG0010459	1	2	1	0	4
OG0010460	1	1	1	1	4
OG0010461	1	1	1	1	4
OG0010462	1	1	1	1	4
OG0010463	1	1	1	1	4
OG0010464	1	1	2	0	4
OG0010465	1	1	1	1	4
OG0010466	1	1	1	1	4
OG0010467	1	1	1	1	4
OG0010468	1	1	1	1	4
OG0010469	1	1	1	1	4
OG0010470	1	1	1	1	4
OG0010471	1	1	2	0	4
OG0010472	1	1	1	1	4
OG0010473	1	1	0	2	4
OG0010474	1	1	1	1	4
OG0010475	1	1	1	1	4
OG0010476	1	1	1	1	4
OG0010477	1	1	1	1	4
OG0010478	1	0	0	3	4
OG0010479	1	3	0	0	4
OG0010480	1	1	1	1	4
OG0010481	1	1	1	1	4
OG0010482	1	1	1	1	4
OG0010483	1	1	1	1	4
OG0010484	1	1	1	1	4
OG0010485	1	1	1	1	4
OG0010486	1	1	1	1	4
OG0010487	1	1	1	1	4
OG0010488	1	1	1	1	4
OG0010489	1	1	1	1	4
OG0010490	1	1	1	1	4
OG0010491	1	1	1	1	4
OG0010492	1	1	1	1	4
OG0010493	1	1	1	1	4
OG0010494	1	1	1	1	4
OG0010495	1	1	1	1	4
OG0010496	1	1	1	1	4
OG0010497	1	1	1	1	4
OG0010498	1	1	1	1	4
OG0010499	1	1	1	1	4
OG0010500	1	1	1	1	4
OG0010501	1	1	1	1	4
OG0010502	1	1	1	1	4
OG0010503	1	1	1	1	4
OG0010504	1	1	1	1	4
OG0010505	1	1	1	1	4
OG0010506	1	1	1	1	4
OG0010507	1	1	1	1	4
OG0010508	1	1	1	1	4
OG0010509	1	1	1	1	4
OG0010510	1	1	1	1	4
OG0010511	1	1	1	1	4
OG0010512	1	1	1	1	4
OG0010513	1	1	1	1	4
OG0010514	1	1	1	1	4
OG0010515	1	1	1	1	4
OG0010516	1	1	1	1	4
OG0010517	1	1	1	1	4
OG0010518	1	0	3	0	4
OG0010519	1	1	1	1	4
OG0010520	1	1	2	0	4
OG0010521	1	1	1	1	4
OG0010522	1	1	1	1	4
OG0010523	1	1	1	1	4
OG0010524	1	1	1	1	4
OG0010525	1	1	1	1	4
OG0010526	1	1	1	1	4
OG0010527	1	1	1	1	4
OG0010528	1	2	0	1	4
OG0010529	1	1	1	1	4
OG0010530	1	1	1	1	4
OG0010531	1	1	1	1	4
OG0010532	1	1	1	1	4
OG0010533	1	1	1	1	4
OG0010534	1	1	1	1	4
OG0010535	1	1	1	1	4
OG0010536	1	1	1	1	4
OG0010537	1	1	1	1	4
OG0010538	1	1	2	0	4
OG0010539	1	1	1	1	4
OG0010540	1	1	1	1	4
OG0010541	1	1	1	1	4
OG0010542	1	1	1	1	4
OG0010543	1	1	1	1	4
OG0010544	1	1	1	1	4
OG0010545	1	1	1	1	4
OG0010546	1	1	1	1	4
OG0010547	1	1	1	1	4
OG0010548	1	1	1	1	4
OG0010549	1	1	1	1	4
OG0010550	1	1	1	1	4
OG0010551	1	1	1	1	4
OG0010552	1	1	1	1	4
OG0010553	1	2	1	0	4
OG0010554	1	1	1	1	4
OG0010555	1	1	1	1	4
OG0010556	1	1	1	1	4
OG0010557	1	1	1	1	4
OG0010558	1	1	1	1	4
OG0010559	1	1	1	1	4
OG0010560	1	1	1	1	4
OG0010561	1	1	2	0	4
OG0010562	1	1	1	1	4
OG0010563	1	1	1	1	4
OG0010564	1	1	1	1	4
OG0010565	1	1	1	1	4
OG0010566	1	1	1	1	4
OG0010567	1	1	1	1	4
OG0010568	1	1	1	1	4
OG0010569	1	1	1	1	4
OG0010570	1	1	1	1	4
OG0010571	1	1	1	1	4
OG0010572	2	1	1	0	4
OG0010573	1	1	1	1	4
OG0010574	1	1	1	1	4
OG0010575	1	1	1	1	4
OG0010576	1	1	1	1	4
OG0010577	1	1	1	1	4
OG0010578	1	1	1	1	4
OG0010579	1	1	1	1	4
OG0010580	1	1	1	1	4
OG0010581	1	1	1	1	4
OG0010582	1	1	1	1	4
OG0010583	1	1	2	0	4
OG0010584	1	1	1	1	4
OG0010585	1	1	1	1	4
OG0010586	1	1	1	1	4
OG0010587	1	1	1	1	4
OG0010588	1	1	1	1	4
OG0010589	1	1	1	1	4
OG0010590	1	1	1	1	4
OG0010591	1	1	1	1	4
OG0010592	1	1	1	1	4
OG0010593	1	1	1	1	4
OG0010594	1	1	1	1	4
OG0010595	1	2	1	0	4
OG0010596	0	3	1	0	4
OG0010597	0	3	1	0	4
OG0010598	0	3	1	0	4
OG0010599	0	4	0	0	4
OG0010600	0	4	0	0	4
OG0010601	0	4	0	0	4
OG0010602	0	1	2	1	4
OG0010603	0	4	0	0	4
OG0010604	0	4	0	0	4
OG0010605	0	4	0	0	4
OG0010606	0	4	0	0	4
OG0010607	0	4	0	0	4
OG0010608	0	1	2	1	4
OG0010609	0	4	0	0	4
OG0010610	0	1	2	1	4
OG0010611	0	4	0	0	4
OG0010612	0	1	0	3	4
OG0010613	0	2	2	0	4
OG0010614	0	4	0	0	4
OG0010615	0	4	0	0	4
OG0010616	0	4	0	0	4
OG0010617	0	4	0	0	4
OG0010618	0	1	3	0	4
OG0010619	0	4	0	0	4
OG0010620	0	4	0	0	4
OG0010621	0	4	0	0	4
OG0010622	0	4	0	0	4
OG0010623	0	4	0	0	4
OG0010624	0	1	3	0	4
OG0010625	0	3	1	0	4
OG0010626	0	2	2	0	4
OG0010627	0	1	3	0	4
OG0010628	0	2	2	0	4
OG0010629	0	4	0	0	4
OG0010630	0	3	1	0	4
OG0010631	0	4	0	0	4
OG0010632	0	4	0	0	4
OG0010633	0	4	0	0	4
OG0010634	0	4	0	0	4
OG0010635	0	2	2	0	4
OG0010636	0	1	3	0	4
OG0010637	0	2	2	0	4
OG0010638	0	4	0	0	4
OG0010639	0	2	2	0	4
OG0010640	0	3	0	1	4
OG0010641	0	4	0	0	4
OG0010642	0	1	1	2	4
OG0010643	0	4	0	0	4
OG0010644	0	1	3	0	4
OG0010645	0	3	1	0	4
OG0010646	0	2	2	0	4
OG0010647	0	4	0	0	4
OG0010648	0	4	0	0	4
OG0010649	0	4	0	0	4
OG0010650	0	1	1	2	4
OG0010651	0	4	0	0	4
OG0010652	0	1	3	0	4
OG0010653	0	4	0	0	4
OG0010654	0	1	1	2	4
OG0010655	0	3	1	0	4
OG0010656	0	1	1	2	4
OG0010657	0	4	0	0	4
OG0010658	0	4	0	0	4
OG0010659	0	1	1	2	4
OG0010660	0	1	1	2	4
OG0010661	0	1	3	0	4
OG0010662	0	1	3	0	4
OG0010663	0	4	0	0	4
OG0010664	0	2	1	1	4
OG0010665	0	1	2	1	4
OG0010666	0	2	1	1	4
OG0010667	0	4	0	0	4
OG0010668	0	4	0	0	4
OG0010669	0	4	0	0	4
OG0010670	0	2	2	0	4
OG0010671	0	3	1	0	4
OG0010672	0	2	2	0	4
OG0010673	0	2	2	0	4
OG0010674	0	4	0	0	4
OG0010675	0	4	0	0	4
OG0010676	0	4	0	0	4
OG0010677	0	3	0	1	4
OG0010678	0	1	2	1	4
OG0010679	0	4	0	0	4
OG0010680	0	4	0	0	4
OG0010681	0	1	3	0	4
OG0010682	0	1	3	0	4
OG0010683	0	1	3	0	4
OG0010684	0	2	1	1	4
OG0010685	0	1	3	0	4
OG0010686	0	1	3	0	4
OG0010687	0	2	2	0	4
OG0010688	0	1	1	2	4
OG0010689	0	1	3	0	4
OG0010690	0	1	3	0	4
OG0010691	0	1	0	3	4
OG0010692	0	4	0	0	4
OG0010693	0	2	2	0	4
OG0010694	0	1	3	0	4
OG0010695	0	3	1	0	4
OG0010696	0	1	2	1	4
OG0010697	0	3	1	0	4
OG0010698	0	4	0	0	4
OG0010699	0	4	0	0	4
OG0010700	0	1	3	0	4
OG0010701	0	3	1	0	4
OG0010702	0	1	0	3	4
OG0010703	0	4	0	0	4
OG0010704	0	0	4	0	4
OG0010705	0	0	4	0	4
OG0010706	0	0	4	0	4
OG0010707	0	0	4	0	4
OG0010708	0	0	4	0	4
OG0010709	0	0	4	0	4
OG0010710	0	0	4	0	4
OG0010711	0	0	4	0	4
OG0010712	0	0	4	0	4
OG0010713	0	0	4	0	4
OG0010714	0	0	4	0	4
OG0010715	0	0	2	2	4
OG0010716	0	0	4	0	4
OG0010717	0	0	4	0	4
OG0010718	0	0	1	3	4
OG0010719	0	0	4	0	4
OG0010720	0	0	4	0	4
OG0010721	0	0	4	0	4
OG0010722	0	0	4	0	4
OG0010723	0	0	4	0	4
OG0010724	0	0	4	0	4
OG0010725	0	0	4	0	4
OG0010726	0	0	4	0	4
OG0010727	0	0	4	0	4
OG0010728	0	0	4	0	4
OG0010729	0	0	4	0	4
OG0010730	0	0	4	0	4
OG0010731	0	0	4	0	4
OG0010732	0	0	4	0	4
OG0010733	0	0	4	0	4
OG0010734	0	0	4	0	4
OG0010735	0	0	4	0	4
OG0010736	0	0	4	0	4
OG0010737	0	0	4	0	4
OG0010738	0	0	2	2	4
OG0010739	0	0	4	0	4
OG0010740	0	0	4	0	4
OG0010741	0	0	4	0	4
OG0010742	0	0	4	0	4
OG0010743	0	0	4	0	4
OG0010744	0	0	1	3	4
OG0010745	0	0	4	0	4
OG0010746	0	0	4	0	4
OG0010747	0	0	4	0	4
OG0010748	0	0	4	0	4
OG0010749	0	0	4	0	4
OG0010750	0	0	4	0	4
OG0010751	0	0	4	0	4
OG0010752	0	0	4	0	4
OG0010753	0	0	4	0	4
OG0010754	0	0	4	0	4
OG0010755	0	0	3	1	4
OG0010756	0	0	4	0	4
OG0010757	0	0	1	3	4
OG0010758	0	0	4	0	4
OG0010759	0	0	4	0	4
OG0010760	0	0	4	0	4
OG0010761	0	0	4	0	4
OG0010762	0	0	4	0	4
OG0010763	0	0	4	0	4
OG0010764	0	0	4	0	4
OG0010765	0	0	1	3	4
OG0010766	0	0	4	0	4
OG0010767	0	0	1	3	4
OG0010768	0	0	4	0	4
OG0010769	0	0	1	3	4
OG0010770	0	0	4	0	4
OG0010771	0	0	1	3	4
OG0010772	0	0	4	0	4
OG0010773	0	0	4	0	4
OG0010774	0	0	4	0	4
OG0010775	0	0	4	0	4
OG0010776	0	0	4	0	4
OG0010777	0	0	4	0	4
OG0010778	0	0	4	0	4
OG0010779	0	0	2	2	4
OG0010780	0	0	2	2	4
OG0010781	0	0	4	0	4
OG0010782	0	0	4	0	4
OG0010783	0	0	4	0	4
OG0010784	0	0	4	0	4
OG0010785	0	0	4	0	4
OG0010786	0	0	4	0	4
OG0010787	0	0	4	0	4
OG0010788	0	0	3	1	4
OG0010789	0	0	2	2	4
OG0010790	0	0	4	0	4
OG0010791	0	0	4	0	4
OG0010792	0	0	4	0	4
OG0010793	0	0	4	0	4
OG0010794	0	0	4	0	4
OG0010795	0	0	1	3	4
OG0010796	0	0	1	3	4
OG0010797	0	0	4	0	4
OG0010798	0	0	3	1	4
OG0010799	0	0	4	0	4
OG0010800	0	0	4	0	4
OG0010801	0	0	4	0	4
OG0010802	0	0	3	1	4
OG0010803	0	0	4	0	4
OG0010804	0	0	4	0	4
OG0010805	0	0	4	0	4
OG0010806	0	0	1	3	4
OG0010807	0	0	4	0	4
OG0010808	0	0	4	0	4
OG0010809	0	0	4	0	4
OG0010810	0	0	4	0	4
OG0010811	0	0	1	3	4
OG0010812	0	0	4	0	4
OG0010813	0	0	4	0	4
OG0010814	0	0	1	3	4
OG0010815	0	0	4	0	4
OG0010816	0	0	4	0	4
OG0010817	0	0	1	3	4
OG0010818	0	0	1	3	4
OG0010819	0	0	0	4	4
OG0010820	0	0	0	4	4
OG0010821	0	0	0	4	4
OG0010822	0	0	0	4	4
OG0010823	0	0	0	4	4
OG0010824	0	0	0	4	4
OG0010825	0	0	0	4	4
OG0010826	0	0	0	4	4
OG0010827	0	0	0	4	4
OG0010828	0	0	0	4	4
OG0010829	0	0	0	4	4
OG0010830	0	0	0	4	4
OG0010831	0	0	0	4	4
OG0010832	0	0	0	4	4
OG0010833	0	0	0	4	4
OG0010834	0	0	0	4	4
OG0010835	0	0	0	4	4
OG0010836	0	0	0	4	4
OG0010837	0	0	0	4	4
OG0010838	0	0	0	4	4
OG0010839	0	0	0	4	4
OG0010840	0	0	0	4	4
OG0010841	0	0	0	4	4
OG0010842	0	0	0	4	4
OG0010843	0	0	0	4	4
OG0010844	0	0	0	4	4
OG0010845	0	0	0	4	4
OG0010846	0	0	0	4	4
OG0010847	0	0	0	4	4
OG0010848	0	0	0	4	4
OG0010849	0	0	0	4	4
OG0010850	0	0	0	4	4
OG0010851	0	0	0	4	4
OG0010852	0	0	0	4	4
OG0010853	0	0	0	4	4
OG0010854	0	0	0	4	4
OG0010855	0	0	0	4	4
OG0010856	0	0	0	4	4
OG0010857	0	0	0	4	4
OG0010858	0	0	0	4	4
OG0010859	0	0	0	4	4
OG0010860	0	0	0	4	4
OG0010861	0	0	0	4	4
OG0010862	0	0	0	4	4
OG0010863	0	0	0	4	4
OG0010864	0	0	0	4	4
OG0010865	0	0	0	4	4
OG0010866	0	0	0	4	4
OG0010867	0	0	0	4	4
OG0010868	0	0	0	4	4
OG0010869	0	0	0	4	4
OG0010870	0	0	0	4	4
OG0010871	0	0	0	4	4
OG0010872	0	0	0	4	4
OG0010873	0	0	0	4	4
OG0010874	0	0	0	4	4
OG0010875	0	0	0	4	4
OG0010876	0	0	0	4	4
OG0010877	0	0	0	4	4
OG0010878	0	0	0	4	4
OG0010879	0	0	0	4	4
OG0010880	0	0	0	4	4
OG0010881	0	0	0	4	4
OG0010882	0	0	0	4	4
OG0010883	0	0	0	4	4
OG0010884	0	0	0	4	4
OG0010885	0	0	0	4	4
OG0010886	0	0	0	4	4
OG0010887	0	0	0	4	4
OG0010888	0	0	0	4	4
OG0010889	0	0	0	4	4
OG0010890	0	0	0	4	4
OG0010891	0	0	0	4	4
OG0010892	0	0	0	4	4
OG0010893	0	0	0	4	4
OG0010894	0	0	0	4	4
OG0010895	0	0	0	4	4
OG0010896	0	0	0	4	4
OG0010897	0	0	0	4	4
OG0010898	0	0	0	4	4
OG0010899	0	0	0	4	4
OG0010900	0	0	0	4	4
OG0010901	0	0	0	4	4
OG0010902	0	0	0	4	4
OG0010903	0	0	0	4	4
OG0010904	0	0	0	4	4
OG0010905	0	0	0	4	4
OG0010906	0	0	0	4	4
OG0010907	0	0	0	4	4
OG0010908	0	0	0	4	4
OG0010909	0	0	0	4	4
OG0010910	0	0	0	4	4
OG0010911	0	0	0	4	4
OG0010912	0	0	0	4	4
OG0010913	0	0	0	4	4
OG0010914	0	0	0	4	4
OG0010915	0	0	0	4	4
OG0010916	0	0	0	4	4
OG0010917	0	0	0	4	4
OG0010918	0	0	0	4	4
OG0010919	0	0	0	4	4
OG0010920	0	0	0	4	4
OG0010921	0	0	0	4	4
OG0010922	0	0	0	4	4
OG0010923	0	0	0	4	4
OG0010924	0	0	0	4	4
OG0010925	0	0	0	4	4
OG0010926	0	0	0	4	4
OG0010927	0	0	0	4	4
OG0010928	0	0	0	4	4
OG0010929	0	0	0	4	4
OG0010930	0	0	0	4	4
OG0010931	0	0	0	4	4
OG0010932	0	0	0	4	4
OG0010933	0	0	0	4	4
OG0010934	0	0	0	4	4
OG0010935	0	0	0	4	4
OG0010936	0	0	0	4	4
OG0010937	0	0	0	4	4
OG0010938	0	0	0	4	4
OG0010939	0	0	0	4	4
OG0010940	0	0	0	4	4
OG0010941	0	0	0	4	4
OG0010942	0	0	0	4	4
OG0010943	0	0	0	4	4
OG0010944	0	0	0	4	4
OG0010945	0	0	0	4	4
OG0010946	0	0	0	4	4
OG0010947	0	0	0	4	4
OG0010948	0	0	0	4	4
OG0010949	0	0	0	4	4
OG0010950	0	0	0	4	4
OG0010951	0	0	0	4	4
OG0010952	0	0	0	4	4
OG0010953	0	0	0	4	4
OG0010954	0	0	0	4	4
OG0010955	0	0	0	4	4
OG0010956	0	0	0	4	4
OG0010957	0	0	0	4	4
OG0010958	0	0	0	4	4
OG0010959	0	0	0	4	4
OG0010960	0	0	0	4	4
OG0010961	0	0	0	4	4
OG0010962	0	0	0	4	4
OG0010963	1	1	1	0	3
OG0010964	1	1	1	0	3
OG0010965	3	0	0	0	3
OG0010966	1	1	1	0	3
OG0010967	1	1	1	0	3
OG0010968	3	0	0	0	3
OG0010969	2	0	1	0	3
OG0010970	1	1	1	0	3
OG0010971	1	1	1	0	3
OG0010972	1	1	1	0	3
OG0010973	1	1	1	0	3
OG0010974	2	1	0	0	3
OG0010975	1	1	1	0	3
OG0010976	1	1	1	0	3
OG0010977	1	1	1	0	3
OG0010978	1	1	1	0	3
OG0010979	1	1	1	0	3
OG0010980	1	1	1	0	3
OG0010981	1	1	1	0	3
OG0010982	1	1	1	0	3
OG0010983	1	1	1	0	3
OG0010984	1	1	0	1	3
OG0010985	1	1	1	0	3
OG0010986	1	1	1	0	3
OG0010987	2	1	0	0	3
OG0010988	3	0	0	0	3
OG0010989	1	1	1	0	3
OG0010990	1	1	1	0	3
OG0010991	1	1	1	0	3
OG0010992	1	1	1	0	3
OG0010993	1	1	1	0	3
OG0010994	1	1	0	1	3
OG0010995	1	1	1	0	3
OG0010996	3	0	0	0	3
OG0010997	1	1	1	0	3
OG0010998	1	1	1	0	3
OG0010999	1	1	0	1	3
OG0011000	1	1	0	1	3
OG0011001	1	1	1	0	3
OG0011002	1	1	1	0	3
OG0011003	1	2	0	0	3
OG0011004	1	1	1	0	3
OG0011005	1	1	1	0	3
OG0011006	1	1	1	0	3
OG0011007	1	1	1	0	3
OG0011008	3	0	0	0	3
OG0011009	1	1	1	0	3
OG0011010	1	0	1	1	3
OG0011011	3	0	0	0	3
OG0011012	1	1	1	0	3
OG0011013	1	0	0	2	3
OG0011014	1	0	1	1	3
OG0011015	1	1	1	0	3
OG0011016	1	0	2	0	3
OG0011017	3	0	0	0	3
OG0011018	1	1	1	0	3
OG0011019	1	1	1	0	3
OG0011020	1	1	1	0	3
OG0011021	1	1	1	0	3
OG0011022	1	1	1	0	3
OG0011023	1	1	1	0	3
OG0011024	1	1	1	0	3
OG0011025	1	1	1	0	3
OG0011026	1	1	1	0	3
OG0011027	1	1	1	0	3
OG0011028	2	0	1	0	3
OG0011029	2	1	0	0	3
OG0011030	1	1	1	0	3
OG0011031	1	1	1	0	3
OG0011032	1	1	1	0	3
OG0011033	1	1	1	0	3
OG0011034	1	1	1	0	3
OG0011035	1	1	1	0	3
OG0011036	1	1	0	1	3
OG0011037	1	1	1	0	3
OG0011038	2	1	0	0	3
OG0011039	1	1	1	0	3
OG0011040	1	1	1	0	3
OG0011041	1	1	1	0	3
OG0011042	1	0	2	0	3
OG0011043	1	1	1	0	3
OG0011044	1	1	0	1	3
OG0011045	1	1	1	0	3
OG0011046	2	1	0	0	3
OG0011047	1	1	1	0	3
OG0011048	1	1	1	0	3
OG0011049	1	1	1	0	3
OG0011050	1	1	1	0	3
OG0011051	1	1	1	0	3
OG0011052	1	1	1	0	3
OG0011053	1	1	1	0	3
OG0011054	1	1	1	0	3
OG0011055	1	1	1	0	3
OG0011056	1	1	1	0	3
OG0011057	1	1	1	0	3
OG0011058	1	1	0	1	3
OG0011059	3	0	0	0	3
OG0011060	1	0	1	1	3
OG0011061	1	0	1	1	3
OG0011062	1	1	1	0	3
OG0011063	1	1	1	0	3
OG0011064	1	1	1	0	3
OG0011065	1	1	1	0	3
OG0011066	1	1	1	0	3
OG0011067	1	1	1	0	3
OG0011068	1	1	1	0	3
OG0011069	1	1	1	0	3
OG0011070	1	1	1	0	3
OG0011071	1	1	1	0	3
OG0011072	1	1	1	0	3
OG0011073	1	1	1	0	3
OG0011074	1	1	1	0	3
OG0011075	1	1	1	0	3
OG0011076	1	1	1	0	3
OG0011077	1	1	1	0	3
OG0011078	1	1	1	0	3
OG0011079	1	1	0	1	3
OG0011080	1	0	1	1	3
OG0011081	1	1	1	0	3
OG0011082	1	1	1	0	3
OG0011083	1	1	1	0	3
OG0011084	1	1	1	0	3
OG0011085	1	1	1	0	3
OG0011086	1	1	1	0	3
OG0011087	1	1	1	0	3
OG0011088	1	1	1	0	3
OG0011089	1	1	1	0	3
OG0011090	1	1	1	0	3
OG0011091	1	1	1	0	3
OG0011092	1	1	1	0	3
OG0011093	1	1	1	0	3
OG0011094	2	1	0	0	3
OG0011095	1	1	1	0	3
OG0011096	1	1	1	0	3
OG0011097	3	0	0	0	3
OG0011098	1	1	1	0	3
OG0011099	1	1	1	0	3
OG0011100	1	1	1	0	3
OG0011101	1	1	1	0	3
OG0011102	1	1	1	0	3
OG0011103	1	1	1	0	3
OG0011104	1	1	1	0	3
OG0011105	1	1	1	0	3
OG0011106	1	1	1	0	3
OG0011107	1	1	1	0	3
OG0011108	1	1	1	0	3
OG0011109	1	1	1	0	3
OG0011110	1	1	1	0	3
OG0011111	1	1	1	0	3
OG0011112	1	1	1	0	3
OG0011113	1	1	1	0	3
OG0011114	1	1	1	0	3
OG0011115	1	1	1	0	3
OG0011116	1	1	1	0	3
OG0011117	1	1	1	0	3
OG0011118	1	1	1	0	3
OG0011119	1	1	1	0	3
OG0011120	1	1	1	0	3
OG0011121	1	1	1	0	3
OG0011122	1	1	1	0	3
OG0011123	3	0	0	0	3
OG0011124	2	0	1	0	3
OG0011125	1	1	1	0	3
OG0011126	1	1	1	0	3
OG0011127	1	1	1	0	3
OG0011128	3	0	0	0	3
OG0011129	1	1	1	0	3
OG0011130	3	0	0	0	3
OG0011131	1	1	1	0	3
OG0011132	1	1	1	0	3
OG0011133	1	1	1	0	3
OG0011134	2	0	1	0	3
OG0011135	1	1	1	0	3
OG0011136	2	0	1	0	3
OG0011137	1	1	1	0	3
OG0011138	1	1	1	0	3
OG0011139	1	1	1	0	3
OG0011140	3	0	0	0	3
OG0011141	1	1	1	0	3
OG0011142	2	1	0	0	3
OG0011143	1	1	1	0	3
OG0011144	1	1	1	0	3
OG0011145	1	0	1	1	3
OG0011146	1	1	1	0	3
OG0011147	1	1	1	0	3
OG0011148	1	1	1	0	3
OG0011149	1	1	1	0	3
OG0011150	1	1	1	0	3
OG0011151	1	1	1	0	3
OG0011152	1	1	1	0	3
OG0011153	1	1	1	0	3
OG0011154	1	1	1	0	3
OG0011155	1	1	1	0	3
OG0011156	1	1	1	0	3
OG0011157	1	1	1	0	3
OG0011158	1	1	1	0	3
OG0011159	1	1	1	0	3
OG0011160	1	1	1	0	3
OG0011161	1	1	1	0	3
OG0011162	1	1	1	0	3
OG0011163	1	1	1	0	3
OG0011164	1	1	1	0	3
OG0011165	1	1	1	0	3
OG0011166	1	1	1	0	3
OG0011167	1	1	1	0	3
OG0011168	1	1	1	0	3
OG0011169	3	0	0	0	3
OG0011170	1	1	0	1	3
OG0011171	1	1	1	0	3
OG0011172	3	0	0	0	3
OG0011173	3	0	0	0	3
OG0011174	1	1	1	0	3
OG0011175	1	1	1	0	3
OG0011176	1	1	1	0	3
OG0011177	3	0	0	0	3
OG0011178	3	0	0	0	3
OG0011179	1	1	1	0	3
OG0011180	1	1	1	0	3
OG0011181	1	1	1	0	3
OG0011182	2	0	1	0	3
OG0011183	1	1	1	0	3
OG0011184	1	1	1	0	3
OG0011185	1	1	1	0	3
OG0011186	1	1	1	0	3
OG0011187	1	1	1	0	3
OG0011188	1	1	1	0	3
OG0011189	3	0	0	0	3
OG0011190	1	2	0	0	3
OG0011191	1	1	1	0	3
OG0011192	3	0	0	0	3
OG0011193	1	0	1	1	3
OG0011194	1	1	1	0	3
OG0011195	1	1	1	0	3
OG0011196	1	1	1	0	3
OG0011197	1	1	1	0	3
OG0011198	1	1	1	0	3
OG0011199	1	1	1	0	3
OG0011200	1	1	1	0	3
OG0011201	1	1	1	0	3
OG0011202	2	1	0	0	3
OG0011203	1	1	1	0	3
OG0011204	1	1	1	0	3
OG0011205	1	1	1	0	3
OG0011206	1	1	0	1	3
OG0011207	1	1	1	0	3
OG0011208	1	1	1	0	3
OG0011209	1	0	2	0	3
OG0011210	1	1	1	0	3
OG0011211	1	1	1	0	3
OG0011212	1	1	1	0	3
OG0011213	1	1	1	0	3
OG0011214	1	0	1	1	3
OG0011215	1	1	1	0	3
OG0011216	1	1	1	0	3
OG0011217	1	1	1	0	3
OG0011218	1	1	1	0	3
OG0011219	1	1	1	0	3
OG0011220	1	1	1	0	3
OG0011221	1	1	1	0	3
OG0011222	1	1	1	0	3
OG0011223	1	1	1	0	3
OG0011224	1	1	1	0	3
OG0011225	1	1	1	0	3
OG0011226	1	1	1	0	3
OG0011227	1	1	0	1	3
OG0011228	1	1	1	0	3
OG0011229	1	1	1	0	3
OG0011230	1	0	1	1	3
OG0011231	1	0	1	1	3
OG0011232	1	1	1	0	3
OG0011233	1	1	1	0	3
OG0011234	1	1	0	1	3
OG0011235	1	1	1	0	3
OG0011236	1	1	1	0	3
OG0011237	3	0	0	0	3
OG0011238	1	1	1	0	3
OG0011239	1	1	1	0	3
OG0011240	1	1	1	0	3
OG0011241	1	1	1	0	3
OG0011242	1	1	1	0	3
OG0011243	1	1	1	0	3
OG0011244	1	1	1	0	3
OG0011245	1	1	1	0	3
OG0011246	1	1	1	0	3
OG0011247	1	1	1	0	3
OG0011248	1	1	1	0	3
OG0011249	1	1	1	0	3
OG0011250	1	1	1	0	3
OG0011251	1	1	1	0	3
OG0011252	1	1	1	0	3
OG0011253	1	1	0	1	3
OG0011254	1	1	1	0	3
OG0011255	2	0	1	0	3
OG0011256	1	1	1	0	3
OG0011257	1	1	1	0	3
OG0011258	1	1	1	0	3
OG0011259	1	1	1	0	3
OG0011260	1	1	1	0	3
OG0011261	1	1	1	0	3
OG0011262	1	1	1	0	3
OG0011263	1	1	1	0	3
OG0011264	1	1	1	0	3
OG0011265	1	0	2	0	3
OG0011266	1	1	1	0	3
OG0011267	1	0	2	0	3
OG0011268	3	0	0	0	3
OG0011269	1	1	1	0	3
OG0011270	1	1	1	0	3
OG0011271	2	1	0	0	3
OG0011272	3	0	0	0	3
OG0011273	1	1	1	0	3
OG0011274	1	1	1	0	3
OG0011275	1	1	1	0	3
OG0011276	1	1	1	0	3
OG0011277	1	1	1	0	3
OG0011278	1	1	1	0	3
OG0011279	3	0	0	0	3
OG0011280	1	1	1	0	3
OG0011281	1	1	1	0	3
OG0011282	1	1	0	1	3
OG0011283	1	1	1	0	3
OG0011284	1	1	1	0	3
OG0011285	1	1	1	0	3
OG0011286	1	1	1	0	3
OG0011287	1	1	1	0	3
OG0011288	1	1	0	1	3
OG0011289	2	1	0	0	3
OG0011290	2	1	0	0	3
OG0011291	1	1	0	1	3
OG0011292	1	1	1	0	3
OG0011293	1	1	0	1	3
OG0011294	1	1	1	0	3
OG0011295	2	1	0	0	3
OG0011296	1	0	1	1	3
OG0011297	1	1	1	0	3
OG0011298	1	1	1	0	3
OG0011299	1	1	1	0	3
OG0011300	1	1	0	1	3
OG0011301	1	1	1	0	3
OG0011302	1	1	1	0	3
OG0011303	1	1	1	0	3
OG0011304	1	1	1	0	3
OG0011305	2	0	1	0	3
OG0011306	1	1	0	1	3
OG0011307	1	1	1	0	3
OG0011308	1	1	1	0	3
OG0011309	1	1	1	0	3
OG0011310	1	1	1	0	3
OG0011311	3	0	0	0	3
OG0011312	1	1	1	0	3
OG0011313	1	0	1	1	3
OG0011314	1	1	1	0	3
OG0011315	1	1	1	0	3
OG0011316	1	1	1	0	3
OG0011317	1	1	1	0	3
OG0011318	1	1	1	0	3
OG0011319	1	1	1	0	3
OG0011320	1	1	1	0	3
OG0011321	3	0	0	0	3
OG0011322	3	0	0	0	3
OG0011323	1	1	1	0	3
OG0011324	1	1	1	0	3
OG0011325	1	1	1	0	3
OG0011326	1	1	1	0	3
OG0011327	1	1	0	1	3
OG0011328	1	1	1	0	3
OG0011329	1	1	1	0	3
OG0011330	1	1	1	0	3
OG0011331	1	1	1	0	3
OG0011332	1	2	0	0	3
OG0011333	1	0	2	0	3
OG0011334	1	1	1	0	3
OG0011335	1	1	0	1	3
OG0011336	1	2	0	0	3
OG0011337	1	1	1	0	3
OG0011338	1	1	1	0	3
OG0011339	1	1	1	0	3
OG0011340	1	1	1	0	3
OG0011341	1	1	1	0	3
OG0011342	1	1	1	0	3
OG0011343	3	0	0	0	3
OG0011344	1	1	0	1	3
OG0011345	1	1	1	0	3
OG0011346	1	1	1	0	3
OG0011347	1	1	0	1	3
OG0011348	1	1	1	0	3
OG0011349	1	1	1	0	3
OG0011350	1	1	1	0	3
OG0011351	1	1	1	0	3
OG0011352	1	1	1	0	3
OG0011353	1	1	1	0	3
OG0011354	1	2	0	0	3
OG0011355	3	0	0	0	3
OG0011356	1	1	1	0	3
OG0011357	1	1	1	0	3
OG0011358	1	1	1	0	3
OG0011359	1	1	1	0	3
OG0011360	1	0	1	1	3
OG0011361	1	1	1	0	3
OG0011362	1	1	1	0	3
OG0011363	1	1	1	0	3
OG0011364	1	1	1	0	3
OG0011365	1	1	1	0	3
OG0011366	1	1	1	0	3
OG0011367	1	1	1	0	3
OG0011368	1	1	1	0	3
OG0011369	1	1	1	0	3
OG0011370	1	1	1	0	3
OG0011371	1	1	1	0	3
OG0011372	1	1	1	0	3
OG0011373	1	1	1	0	3
OG0011374	1	1	1	0	3
OG0011375	1	1	1	0	3
OG0011376	1	1	1	0	3
OG0011377	1	1	1	0	3
OG0011378	1	2	0	0	3
OG0011379	1	2	0	0	3
OG0011380	1	1	1	0	3
OG0011381	1	1	1	0	3
OG0011382	1	1	1	0	3
OG0011383	1	1	0	1	3
OG0011384	1	1	1	0	3
OG0011385	1	1	1	0	3
OG0011386	1	1	1	0	3
OG0011387	1	1	1	0	3
OG0011388	3	0	0	0	3
OG0011389	1	1	1	0	3
OG0011390	1	1	1	0	3
OG0011391	3	0	0	0	3
OG0011392	1	1	1	0	3
OG0011393	1	1	1	0	3
OG0011394	1	1	1	0	3
OG0011395	1	1	1	0	3
OG0011396	1	1	1	0	3
OG0011397	1	1	1	0	3
OG0011398	1	1	1	0	3
OG0011399	1	1	1	0	3
OG0011400	2	1	0	0	3
OG0011401	1	1	1	0	3
OG0011402	1	1	1	0	3
OG0011403	1	0	1	1	3
OG0011404	1	1	1	0	3
OG0011405	2	1	0	0	3
OG0011406	1	1	1	0	3
OG0011407	3	0	0	0	3
OG0011408	1	1	1	0	3
OG0011409	1	1	1	0	3
OG0011410	1	2	0	0	3
OG0011411	2	0	1	0	3
OG0011412	1	1	1	0	3
OG0011413	1	1	0	1	3
OG0011414	1	1	1	0	3
OG0011415	1	1	1	0	3
OG0011416	1	1	1	0	3
OG0011417	1	1	1	0	3
OG0011418	1	1	1	0	3
OG0011419	1	1	1	0	3
OG0011420	1	1	1	0	3
OG0011421	1	1	1	0	3
OG0011422	1	1	1	0	3
OG0011423	1	1	1	0	3
OG0011424	1	1	0	1	3
OG0011425	1	1	1	0	3
OG0011426	3	0	0	0	3
OG0011427	1	1	0	1	3
OG0011428	1	0	1	1	3
OG0011429	1	1	1	0	3
OG0011430	1	0	2	0	3
OG0011431	1	1	1	0	3
OG0011432	1	1	1	0	3
OG0011433	1	1	1	0	3
OG0011434	1	1	1	0	3
OG0011435	1	1	1	0	3
OG0011436	1	1	1	0	3
OG0011437	1	1	1	0	3
OG0011438	1	1	1	0	3
OG0011439	1	1	1	0	3
OG0011440	1	1	1	0	3
OG0011441	1	1	1	0	3
OG0011442	1	1	1	0	3
OG0011443	2	0	1	0	3
OG0011444	1	1	1	0	3
OG0011445	1	1	1	0	3
OG0011446	1	1	1	0	3
OG0011447	1	1	1	0	3
OG0011448	1	1	1	0	3
OG0011449	1	1	1	0	3
OG0011450	1	1	1	0	3
OG0011451	1	1	1	0	3
OG0011452	1	1	1	0	3
OG0011453	1	1	1	0	3
OG0011454	1	1	1	0	3
OG0011455	1	1	1	0	3
OG0011456	1	1	1	0	3
OG0011457	1	1	1	0	3
OG0011458	3	0	0	0	3
OG0011459	3	0	0	0	3
OG0011460	1	1	1	0	3
OG0011461	1	1	1	0	3
OG0011462	2	0	1	0	3
OG0011463	1	1	1	0	3
OG0011464	1	1	1	0	3
OG0011465	1	1	1	0	3
OG0011466	1	1	1	0	3
OG0011467	1	1	1	0	3
OG0011468	1	1	1	0	3
OG0011469	1	1	1	0	3
OG0011470	1	1	1	0	3
OG0011471	1	1	1	0	3
OG0011472	1	1	1	0	3
OG0011473	1	1	1	0	3
OG0011474	1	1	1	0	3
OG0011475	1	1	1	0	3
OG0011476	1	1	1	0	3
OG0011477	1	1	1	0	3
OG0011478	2	1	0	0	3
OG0011479	1	1	1	0	3
OG0011480	1	1	1	0	3
OG0011481	1	1	1	0	3
OG0011482	1	1	1	0	3
OG0011483	1	1	0	1	3
OG0011484	2	0	1	0	3
OG0011485	1	1	1	0	3
OG0011486	3	0	0	0	3
OG0011487	1	1	1	0	3
OG0011488	1	1	1	0	3
OG0011489	2	1	0	0	3
OG0011490	2	1	0	0	3
OG0011491	1	1	0	1	3
OG0011492	1	1	1	0	3
OG0011493	1	1	1	0	3
OG0011494	1	1	1	0	3
OG0011495	1	1	1	0	3
OG0011496	1	1	1	0	3
OG0011497	1	1	1	0	3
OG0011498	1	1	0	1	3
OG0011499	3	0	0	0	3
OG0011500	3	0	0	0	3
OG0011501	1	1	1	0	3
OG0011502	1	0	1	1	3
OG0011503	1	1	1	0	3
OG0011504	1	1	1	0	3
OG0011505	1	1	1	0	3
OG0011506	1	1	1	0	3
OG0011507	1	1	1	0	3
OG0011508	1	1	1	0	3
OG0011509	1	0	2	0	3
OG0011510	1	1	1	0	3
OG0011511	1	1	1	0	3
OG0011512	1	1	1	0	3
OG0011513	3	0	0	0	3
OG0011514	2	1	0	0	3
OG0011515	3	0	0	0	3
OG0011516	1	1	1	0	3
OG0011517	1	1	1	0	3
OG0011518	1	1	1	0	3
OG0011519	1	1	1	0	3
OG0011520	1	1	1	0	3
OG0011521	1	1	1	0	3
OG0011522	1	1	1	0	3
OG0011523	3	0	0	0	3
OG0011524	1	1	1	0	3
OG0011525	1	1	1	0	3
OG0011526	2	0	1	0	3
OG0011527	1	1	1	0	3
OG0011528	1	1	1	0	3
OG0011529	1	1	1	0	3
OG0011530	1	1	1	0	3
OG0011531	1	1	0	1	3
OG0011532	1	1	1	0	3
OG0011533	1	1	1	0	3
OG0011534	1	1	1	0	3
OG0011535	1	1	1	0	3
OG0011536	1	1	1	0	3
OG0011537	1	1	1	0	3
OG0011538	1	1	1	0	3
OG0011539	1	1	1	0	3
OG0011540	1	1	1	0	3
OG0011541	3	0	0	0	3
OG0011542	1	1	1	0	3
OG0011543	2	1	0	0	3
OG0011544	2	0	0	1	3
OG0011545	1	1	1	0	3
OG0011546	1	1	1	0	3
OG0011547	1	1	1	0	3
OG0011548	1	1	1	0	3
OG0011549	1	1	1	0	3
OG0011550	1	1	1	0	3
OG0011551	3	0	0	0	3
OG0011552	1	1	1	0	3
OG0011553	1	1	1	0	3
OG0011554	1	1	1	0	3
OG0011555	1	1	0	1	3
OG0011556	1	1	0	1	3
OG0011557	1	1	1	0	3
OG0011558	1	1	1	0	3
OG0011559	1	1	1	0	3
OG0011560	1	1	1	0	3
OG0011561	1	1	1	0	3
OG0011562	1	1	1	0	3
OG0011563	2	1	0	0	3
OG0011564	1	1	1	0	3
OG0011565	1	1	1	0	3
OG0011566	1	0	1	1	3
OG0011567	3	0	0	0	3
OG0011568	2	0	1	0	3
OG0011569	1	1	1	0	3
OG0011570	1	1	1	0	3
OG0011571	1	1	1	0	3
OG0011572	1	1	1	0	3
OG0011573	1	1	1	0	3
OG0011574	1	1	1	0	3
OG0011575	1	0	1	1	3
OG0011576	1	0	2	0	3
OG0011577	2	1	0	0	3
OG0011578	1	1	1	0	3
OG0011579	1	1	1	0	3
OG0011580	1	1	1	0	3
OG0011581	1	1	1	0	3
OG0011582	1	1	1	0	3
OG0011583	1	1	1	0	3
OG0011584	1	1	1	0	3
OG0011585	1	1	1	0	3
OG0011586	1	1	1	0	3
OG0011587	1	0	2	0	3
OG0011588	1	1	1	0	3
OG0011589	3	0	0	0	3
OG0011590	1	1	1	0	3
OG0011591	3	0	0	0	3
OG0011592	1	1	1	0	3
OG0011593	1	1	1	0	3
OG0011594	3	0	0	0	3
OG0011595	1	1	1	0	3
OG0011596	1	1	1	0	3
OG0011597	1	1	1	0	3
OG0011598	1	1	1	0	3
OG0011599	3	0	0	0	3
OG0011600	1	1	1	0	3
OG0011601	1	1	1	0	3
OG0011602	2	0	0	1	3
OG0011603	2	0	1	0	3
OG0011604	3	0	0	0	3
OG0011605	1	1	1	0	3
OG0011606	1	0	1	1	3
OG0011607	1	1	1	0	3
OG0011608	1	1	1	0	3
OG0011609	1	1	1	0	3
OG0011610	2	0	1	0	3
OG0011611	1	2	0	0	3
OG0011612	1	1	1	0	3
OG0011613	1	1	1	0	3
OG0011614	1	1	1	0	3
OG0011615	1	1	1	0	3
OG0011616	3	0	0	0	3
OG0011617	1	1	1	0	3
OG0011618	2	1	0	0	3
OG0011619	3	0	0	0	3
OG0011620	1	1	1	0	3
OG0011621	1	1	1	0	3
OG0011622	1	1	1	0	3
OG0011623	1	1	0	1	3
OG0011624	2	0	0	1	3
OG0011625	1	2	0	0	3
OG0011626	1	1	1	0	3
OG0011627	1	1	1	0	3
OG0011628	1	1	1	0	3
OG0011629	1	1	1	0	3
OG0011630	1	1	1	0	3
OG0011631	1	1	1	0	3
OG0011632	1	1	1	0	3
OG0011633	1	1	1	0	3
OG0011634	1	1	1	0	3
OG0011635	1	1	1	0	3
OG0011636	1	0	1	1	3
OG0011637	1	1	1	0	3
OG0011638	1	1	1	0	3
OG0011639	2	1	0	0	3
OG0011640	1	1	1	0	3
OG0011641	1	1	1	0	3
OG0011642	1	1	1	0	3
OG0011643	1	1	0	1	3
OG0011644	1	1	1	0	3
OG0011645	1	1	1	0	3
OG0011646	1	0	1	1	3
OG0011647	1	1	1	0	3
OG0011648	1	1	1	0	3
OG0011649	1	1	1	0	3
OG0011650	2	0	0	1	3
OG0011651	1	1	1	0	3
OG0011652	2	1	0	0	3
OG0011653	1	1	0	1	3
OG0011654	3	0	0	0	3
OG0011655	1	1	1	0	3
OG0011656	1	1	1	0	3
OG0011657	1	1	1	0	3
OG0011658	1	1	1	0	3
OG0011659	1	1	1	0	3
OG0011660	1	1	1	0	3
OG0011661	1	1	1	0	3
OG0011662	1	0	1	1	3
OG0011663	1	1	1	0	3
OG0011664	3	0	0	0	3
OG0011665	3	0	0	0	3
OG0011666	1	1	1	0	3
OG0011667	1	1	1	0	3
OG0011668	2	1	0	0	3
OG0011669	1	1	1	0	3
OG0011670	1	1	1	0	3
OG0011671	1	1	1	0	3
OG0011672	1	1	1	0	3
OG0011673	1	1	1	0	3
OG0011674	1	1	1	0	3
OG0011675	1	1	1	0	3
OG0011676	1	1	1	0	3
OG0011677	1	1	1	0	3
OG0011678	1	1	1	0	3
OG0011679	1	1	1	0	3
OG0011680	1	1	1	0	3
OG0011681	1	1	1	0	3
OG0011682	2	0	1	0	3
OG0011683	1	1	1	0	3
OG0011684	1	1	1	0	3
OG0011685	1	1	1	0	3
OG0011686	2	0	1	0	3
OG0011687	1	1	1	0	3
OG0011688	1	1	1	0	3
OG0011689	1	1	1	0	3
OG0011690	1	1	1	0	3
OG0011691	1	1	1	0	3
OG0011692	1	0	1	1	3
OG0011693	1	0	0	2	3
OG0011694	1	1	1	0	3
OG0011695	2	1	0	0	3
OG0011696	1	1	1	0	3
OG0011697	3	0	0	0	3
OG0011698	1	1	1	0	3
OG0011699	1	1	1	0	3
OG0011700	1	1	1	0	3
OG0011701	1	1	1	0	3
OG0011702	2	0	1	0	3
OG0011703	1	1	1	0	3
OG0011704	1	1	1	0	3
OG0011705	1	1	1	0	3
OG0011706	1	1	1	0	3
OG0011707	1	1	1	0	3
OG0011708	1	1	1	0	3
OG0011709	1	1	1	0	3
OG0011710	1	1	1	0	3
OG0011711	2	1	0	0	3
OG0011712	1	1	1	0	3
OG0011713	1	1	1	0	3
OG0011714	1	0	2	0	3
OG0011715	1	1	1	0	3
OG0011716	1	1	1	0	3
OG0011717	1	1	1	0	3
OG0011718	1	1	1	0	3
OG0011719	1	1	1	0	3
OG0011720	1	1	1	0	3
OG0011721	1	1	1	0	3
OG0011722	1	1	1	0	3
OG0011723	1	1	1	0	3
OG0011724	1	1	1	0	3
OG0011725	1	1	1	0	3
OG0011726	1	1	1	0	3
OG0011727	1	0	1	1	3
OG0011728	3	0	0	0	3
OG0011729	1	1	1	0	3
OG0011730	1	1	1	0	3
OG0011731	3	0	0	0	3
OG0011732	1	1	1	0	3
OG0011733	1	1	1	0	3
OG0011734	1	0	0	2	3
OG0011735	1	1	1	0	3
OG0011736	1	1	1	0	3
OG0011737	2	1	0	0	3
OG0011738	1	1	1	0	3
OG0011739	1	1	1	0	3
OG0011740	3	0	0	0	3
OG0011741	1	1	1	0	3
OG0011742	1	1	1	0	3
OG0011743	3	0	0	0	3
OG0011744	1	1	1	0	3
OG0011745	1	1	1	0	3
OG0011746	1	1	1	0	3
OG0011747	1	1	1	0	3
OG0011748	1	1	1	0	3
OG0011749	1	0	2	0	3
OG0011750	1	1	1	0	3
OG0011751	1	1	1	0	3
OG0011752	1	1	0	1	3
OG0011753	1	1	1	0	3
OG0011754	1	1	1	0	3
OG0011755	1	1	1	0	3
OG0011756	1	1	1	0	3
OG0011757	3	0	0	0	3
OG0011758	1	1	1	0	3
OG0011759	1	1	1	0	3
OG0011760	1	1	1	0	3
OG0011761	1	0	1	1	3
OG0011762	1	1	1	0	3
OG0011763	1	1	1	0	3
OG0011764	1	1	1	0	3
OG0011765	1	1	1	0	3
OG0011766	1	1	1	0	3
OG0011767	1	1	1	0	3
OG0011768	1	1	1	0	3
OG0011769	1	1	1	0	3
OG0011770	1	1	1	0	3
OG0011771	1	1	1	0	3
OG0011772	1	1	1	0	3
OG0011773	1	1	1	0	3
OG0011774	1	1	1	0	3
OG0011775	3	0	0	0	3
OG0011776	1	1	1	0	3
OG0011777	1	1	0	1	3
OG0011778	1	0	1	1	3
OG0011779	1	1	1	0	3
OG0011780	1	1	1	0	3
OG0011781	1	1	1	0	3
OG0011782	1	1	1	0	3
OG0011783	1	1	1	0	3
OG0011784	1	1	1	0	3
OG0011785	1	1	1	0	3
OG0011786	1	1	1	0	3
OG0011787	1	1	1	0	3
OG0011788	1	1	1	0	3
OG0011789	1	1	1	0	3
OG0011790	1	1	1	0	3
OG0011791	1	1	1	0	3
OG0011792	3	0	0	0	3
OG0011793	1	1	1	0	3
OG0011794	1	1	0	1	3
OG0011795	1	1	1	0	3
OG0011796	1	1	1	0	3
OG0011797	1	1	1	0	3
OG0011798	1	1	1	0	3
OG0011799	1	0	1	1	3
OG0011800	2	1	0	0	3
OG0011801	1	1	1	0	3
OG0011802	1	1	1	0	3
OG0011803	1	1	1	0	3
OG0011804	1	1	0	1	3
OG0011805	1	1	1	0	3
OG0011806	1	1	1	0	3
OG0011807	3	0	0	0	3
OG0011808	1	1	1	0	3
OG0011809	1	1	1	0	3
OG0011810	1	1	1	0	3
OG0011811	1	1	1	0	3
OG0011812	1	1	1	0	3
OG0011813	1	1	1	0	3
OG0011814	3	0	0	0	3
OG0011815	1	1	1	0	3
OG0011816	2	0	0	1	3
OG0011817	1	1	1	0	3
OG0011818	1	1	1	0	3
OG0011819	1	1	1	0	3
OG0011820	1	1	1	0	3
OG0011821	1	1	1	0	3
OG0011822	1	1	1	0	3
OG0011823	1	1	1	0	3
OG0011824	3	0	0	0	3
OG0011825	1	1	1	0	3
OG0011826	1	1	1	0	3
OG0011827	1	1	1	0	3
OG0011828	1	1	1	0	3
OG0011829	1	1	1	0	3
OG0011830	1	1	1	0	3
OG0011831	1	1	1	0	3
OG0011832	1	1	1	0	3
OG0011833	1	1	1	0	3
OG0011834	1	1	1	0	3
OG0011835	1	1	1	0	3
OG0011836	1	1	1	0	3
OG0011837	1	1	1	0	3
OG0011838	1	1	1	0	3
OG0011839	3	0	0	0	3
OG0011840	1	1	1	0	3
OG0011841	1	1	1	0	3
OG0011842	1	1	1	0	3
OG0011843	1	1	1	0	3
OG0011844	1	1	1	0	3
OG0011845	1	1	1	0	3
OG0011846	1	1	1	0	3
OG0011847	1	1	1	0	3
OG0011848	1	1	1	0	3
OG0011849	1	0	2	0	3
OG0011850	1	1	1	0	3
OG0011851	1	1	1	0	3
OG0011852	1	1	1	0	3
OG0011853	1	1	1	0	3
OG0011854	1	1	1	0	3
OG0011855	3	0	0	0	3
OG0011856	1	1	1	0	3
OG0011857	1	1	1	0	3
OG0011858	1	1	1	0	3
OG0011859	1	1	0	1	3
OG0011860	1	1	1	0	3
OG0011861	1	1	1	0	3
OG0011862	1	1	1	0	3
OG0011863	1	1	1	0	3
OG0011864	3	0	0	0	3
OG0011865	1	1	1	0	3
OG0011866	1	1	1	0	3
OG0011867	1	1	1	0	3
OG0011868	1	1	1	0	3
OG0011869	1	1	1	0	3
OG0011870	1	1	1	0	3
OG0011871	1	1	1	0	3
OG0011872	1	1	1	0	3
OG0011873	1	1	1	0	3
OG0011874	1	1	1	0	3
OG0011875	1	1	1	0	3
OG0011876	1	1	1	0	3
OG0011877	1	1	1	0	3
OG0011878	1	1	1	0	3
OG0011879	1	1	1	0	3
OG0011880	1	1	1	0	3
OG0011881	1	1	1	0	3
OG0011882	1	1	1	0	3
OG0011883	1	1	1	0	3
OG0011884	1	1	1	0	3
OG0011885	1	1	1	0	3
OG0011886	1	1	1	0	3
OG0011887	1	1	1	0	3
OG0011888	1	1	0	1	3
OG0011889	1	1	1	0	3
OG0011890	1	1	1	0	3
OG0011891	1	1	1	0	3
OG0011892	1	1	1	0	3
OG0011893	1	1	1	0	3
OG0011894	1	1	1	0	3
OG0011895	1	1	1	0	3
OG0011896	1	1	1	0	3
OG0011897	1	1	1	0	3
OG0011898	1	1	1	0	3
OG0011899	1	1	1	0	3
OG0011900	1	1	1	0	3
OG0011901	1	1	1	0	3
OG0011902	1	1	1	0	3
OG0011903	1	2	0	0	3
OG0011904	1	1	1	0	3
OG0011905	1	1	1	0	3
OG0011906	1	1	1	0	3
OG0011907	1	1	1	0	3
OG0011908	1	1	1	0	3
OG0011909	1	1	1	0	3
OG0011910	1	1	1	0	3
OG0011911	1	1	1	0	3
OG0011912	1	1	1	0	3
OG0011913	1	1	1	0	3
OG0011914	1	1	1	0	3
OG0011915	1	1	1	0	3
OG0011916	1	1	1	0	3
OG0011917	1	1	1	0	3
OG0011918	1	1	1	0	3
OG0011919	1	0	1	1	3
OG0011920	1	1	1	0	3
OG0011921	1	1	1	0	3
OG0011922	3	0	0	0	3
OG0011923	2	1	0	0	3
OG0011924	3	0	0	0	3
OG0011925	1	1	0	1	3
OG0011926	1	1	1	0	3
OG0011927	1	0	1	1	3
OG0011928	1	1	1	0	3
OG0011929	1	1	1	0	3
OG0011930	1	1	1	0	3
OG0011931	1	1	1	0	3
OG0011932	1	1	1	0	3
OG0011933	1	1	1	0	3
OG0011934	1	1	1	0	3
OG0011935	1	1	1	0	3
OG0011936	2	1	0	0	3
OG0011937	1	1	1	0	3
OG0011938	1	1	1	0	3
OG0011939	1	1	1	0	3
OG0011940	1	1	1	0	3
OG0011941	1	1	1	0	3
OG0011942	1	1	1	0	3
OG0011943	1	1	1	0	3
OG0011944	1	1	1	0	3
OG0011945	1	1	1	0	3
OG0011946	1	1	1	0	3
OG0011947	1	1	1	0	3
OG0011948	1	1	1	0	3
OG0011949	1	1	1	0	3
OG0011950	1	1	1	0	3
OG0011951	1	1	1	0	3
OG0011952	1	1	1	0	3
OG0011953	1	1	1	0	3
OG0011954	1	1	1	0	3
OG0011955	1	1	1	0	3
OG0011956	1	1	1	0	3
OG0011957	1	1	1	0	3
OG0011958	3	0	0	0	3
OG0011959	3	0	0	0	3
OG0011960	2	1	0	0	3
OG0011961	1	1	1	0	3
OG0011962	1	1	1	0	3
OG0011963	1	1	1	0	3
OG0011964	1	1	1	0	3
OG0011965	1	1	1	0	3
OG0011966	1	1	1	0	3
OG0011967	1	1	1	0	3
OG0011968	1	1	1	0	3
OG0011969	1	1	1	0	3
OG0011970	1	0	0	2	3
OG0011971	1	2	0	0	3
OG0011972	1	1	1	0	3
OG0011973	2	1	0	0	3
OG0011974	1	1	1	0	3
OG0011975	1	1	1	0	3
OG0011976	1	1	1	0	3
OG0011977	1	1	1	0	3
OG0011978	1	1	1	0	3
OG0011979	1	1	1	0	3
OG0011980	3	0	0	0	3
OG0011981	1	1	1	0	3
OG0011982	1	1	1	0	3
OG0011983	1	1	1	0	3
OG0011984	1	1	1	0	3
OG0011985	1	1	1	0	3
OG0011986	1	1	1	0	3
OG0011987	1	1	1	0	3
OG0011988	1	1	1	0	3
OG0011989	1	1	1	0	3
OG0011990	1	0	1	1	3
OG0011991	1	0	1	1	3
OG0011992	1	1	1	0	3
OG0011993	1	1	1	0	3
OG0011994	1	1	1	0	3
OG0011995	1	1	1	0	3
OG0011996	2	1	0	0	3
OG0011997	2	1	0	0	3
OG0011998	1	1	1	0	3
OG0011999	1	1	1	0	3
OG0012000	1	1	1	0	3
OG0012001	1	1	1	0	3
OG0012002	1	1	1	0	3
OG0012003	1	1	1	0	3
OG0012004	1	1	1	0	3
OG0012005	1	1	1	0	3
OG0012006	1	1	1	0	3
OG0012007	1	1	1	0	3
OG0012008	1	1	1	0	3
OG0012009	1	1	1	0	3
OG0012010	1	1	0	1	3
OG0012011	1	1	1	0	3
OG0012012	3	0	0	0	3
OG0012013	2	1	0	0	3
OG0012014	1	1	1	0	3
OG0012015	1	1	1	0	3
OG0012016	2	1	0	0	3
OG0012017	1	1	1	0	3
OG0012018	1	1	1	0	3
OG0012019	1	1	1	0	3
OG0012020	1	1	1	0	3
OG0012021	1	1	1	0	3
OG0012022	1	1	1	0	3
OG0012023	1	0	1	1	3
OG0012024	1	1	1	0	3
OG0012025	1	0	1	1	3
OG0012026	2	1	0	0	3
OG0012027	1	1	1	0	3
OG0012028	1	1	1	0	3
OG0012029	1	1	1	0	3
OG0012030	1	1	1	0	3
OG0012031	1	1	1	0	3
OG0012032	1	1	1	0	3
OG0012033	1	1	1	0	3
OG0012034	1	1	1	0	3
OG0012035	1	1	1	0	3
OG0012036	1	1	1	0	3
OG0012037	1	1	1	0	3
OG0012038	1	1	1	0	3
OG0012039	1	1	1	0	3
OG0012040	1	1	1	0	3
OG0012041	1	1	1	0	3
OG0012042	2	1	0	0	3
OG0012043	1	1	1	0	3
OG0012044	2	0	1	0	3
OG0012045	1	1	1	0	3
OG0012046	1	1	1	0	3
OG0012047	1	1	1	0	3
OG0012048	1	1	1	0	3
OG0012049	1	1	1	0	3
OG0012050	1	1	1	0	3
OG0012051	1	1	1	0	3
OG0012052	1	1	1	0	3
OG0012053	1	0	1	1	3
OG0012054	1	1	1	0	3
OG0012055	1	1	1	0	3
OG0012056	1	1	1	0	3
OG0012057	2	0	1	0	3
OG0012058	1	1	1	0	3
OG0012059	1	1	1	0	3
OG0012060	1	1	1	0	3
OG0012061	1	1	1	0	3
OG0012062	1	1	1	0	3
OG0012063	1	1	1	0	3
OG0012064	1	1	1	0	3
OG0012065	1	0	1	1	3
OG0012066	1	1	1	0	3
OG0012067	1	1	1	0	3
OG0012068	1	1	1	0	3
OG0012069	1	1	1	0	3
OG0012070	1	1	1	0	3
OG0012071	1	1	1	0	3
OG0012072	1	1	1	0	3
OG0012073	1	1	1	0	3
OG0012074	1	1	1	0	3
OG0012075	1	1	1	0	3
OG0012076	1	1	1	0	3
OG0012077	1	1	1	0	3
OG0012078	1	1	1	0	3
OG0012079	1	1	1	0	3
OG0012080	1	1	1	0	3
OG0012081	1	1	1	0	3
OG0012082	1	1	1	0	3
OG0012083	1	1	1	0	3
OG0012084	1	1	1	0	3
OG0012085	1	1	1	0	3
OG0012086	1	1	1	0	3
OG0012087	1	1	1	0	3
OG0012088	1	1	1	0	3
OG0012089	1	1	1	0	3
OG0012090	3	0	0	0	3
OG0012091	1	1	1	0	3
OG0012092	1	1	1	0	3
OG0012093	1	1	1	0	3
OG0012094	1	1	1	0	3
OG0012095	1	1	1	0	3
OG0012096	3	0	0	0	3
OG0012097	1	1	1	0	3
OG0012098	1	1	1	0	3
OG0012099	1	1	1	0	3
OG0012100	1	1	1	0	3
OG0012101	1	1	1	0	3
OG0012102	1	1	1	0	3
OG0012103	1	1	1	0	3
OG0012104	1	1	1	0	3
OG0012105	1	1	1	0	3
OG0012106	1	1	1	0	3
OG0012107	1	1	1	0	3
OG0012108	1	1	1	0	3
OG0012109	1	1	1	0	3
OG0012110	1	1	1	0	3
OG0012111	3	0	0	0	3
OG0012112	1	1	1	0	3
OG0012113	1	1	1	0	3
OG0012114	1	1	1	0	3
OG0012115	1	1	1	0	3
OG0012116	1	1	1	0	3
OG0012117	1	0	2	0	3
OG0012118	2	0	1	0	3
OG0012119	2	0	1	0	3
OG0012120	3	0	0	0	3
OG0012121	1	1	1	0	3
OG0012122	1	1	0	1	3
OG0012123	1	1	1	0	3
OG0012124	1	1	1	0	3
OG0012125	1	1	1	0	3
OG0012126	1	1	0	1	3
OG0012127	1	1	1	0	3
OG0012128	1	0	0	2	3
OG0012129	1	1	0	1	3
OG0012130	1	1	0	1	3
OG0012131	3	0	0	0	3
OG0012132	1	1	1	0	3
OG0012133	1	1	1	0	3
OG0012134	1	1	1	0	3
OG0012135	1	1	0	1	3
OG0012136	1	1	1	0	3
OG0012137	1	1	1	0	3
OG0012138	1	1	1	0	3
OG0012139	1	1	1	0	3
OG0012140	1	1	1	0	3
OG0012141	1	1	1	0	3
OG0012142	1	1	1	0	3
OG0012143	1	1	1	0	3
OG0012144	1	1	1	0	3
OG0012145	1	1	1	0	3
OG0012146	1	1	1	0	3
OG0012147	1	1	1	0	3
OG0012148	1	1	1	0	3
OG0012149	1	1	1	0	3
OG0012150	1	1	1	0	3
OG0012151	1	1	1	0	3
OG0012152	1	1	1	0	3
OG0012153	1	1	1	0	3
OG0012154	1	0	2	0	3
OG0012155	3	0	0	0	3
OG0012156	1	1	1	0	3
OG0012157	1	1	1	0	3
OG0012158	1	1	1	0	3
OG0012159	1	1	1	0	3
OG0012160	1	1	1	0	3
OG0012161	1	1	1	0	3
OG0012162	1	1	1	0	3
OG0012163	1	1	1	0	3
OG0012164	1	1	1	0	3
OG0012165	1	1	1	0	3
OG0012166	1	1	1	0	3
OG0012167	1	1	1	0	3
OG0012168	1	1	1	0	3
OG0012169	1	1	1	0	3
OG0012170	1	1	1	0	3
OG0012171	1	2	0	0	3
OG0012172	3	0	0	0	3
OG0012173	1	1	1	0	3
OG0012174	1	1	1	0	3
OG0012175	1	1	1	0	3
OG0012176	1	1	1	0	3
OG0012177	1	1	1	0	3
OG0012178	1	1	1	0	3
OG0012179	3	0	0	0	3
OG0012180	1	1	1	0	3
OG0012181	1	1	1	0	3
OG0012182	1	0	2	0	3
OG0012183	1	1	1	0	3
OG0012184	2	1	0	0	3
OG0012185	1	1	1	0	3
OG0012186	1	1	1	0	3
OG0012187	1	1	1	0	3
OG0012188	1	1	1	0	3
OG0012189	1	1	1	0	3
OG0012190	1	1	0	1	3
OG0012191	1	1	1	0	3
OG0012192	1	1	1	0	3
OG0012193	1	1	1	0	3
OG0012194	1	1	1	0	3
OG0012195	1	1	1	0	3
OG0012196	1	1	1	0	3
OG0012197	1	1	1	0	3
OG0012198	1	1	1	0	3
OG0012199	1	1	1	0	3
OG0012200	1	1	1	0	3
OG0012201	1	1	1	0	3
OG0012202	2	1	0	0	3
OG0012203	1	1	1	0	3
OG0012204	1	1	1	0	3
OG0012205	1	1	1	0	3
OG0012206	2	0	1	0	3
OG0012207	1	1	1	0	3
OG0012208	1	1	1	0	3
OG0012209	1	1	1	0	3
OG0012210	3	0	0	0	3
OG0012211	1	1	1	0	3
OG0012212	1	1	1	0	3
OG0012213	1	1	1	0	3
OG0012214	1	1	1	0	3
OG0012215	1	1	1	0	3
OG0012216	1	1	1	0	3
OG0012217	1	1	1	0	3
OG0012218	1	1	1	0	3
OG0012219	1	1	1	0	3
OG0012220	1	1	1	0	3
OG0012221	1	1	1	0	3
OG0012222	1	1	1	0	3
OG0012223	1	1	1	0	3
OG0012224	1	1	1	0	3
OG0012225	1	1	1	0	3
OG0012226	3	0	0	0	3
OG0012227	1	0	1	1	3
OG0012228	1	1	1	0	3
OG0012229	1	1	1	0	3
OG0012230	2	1	0	0	3
OG0012231	1	1	1	0	3
OG0012232	2	1	0	0	3
OG0012233	1	1	1	0	3
OG0012234	1	1	1	0	3
OG0012235	1	1	0	1	3
OG0012236	3	0	0	0	3
OG0012237	1	1	1	0	3
OG0012238	1	1	1	0	3
OG0012239	1	1	1	0	3
OG0012240	1	1	1	0	3
OG0012241	1	1	1	0	3
OG0012242	1	1	0	1	3
OG0012243	1	1	1	0	3
OG0012244	1	1	1	0	3
OG0012245	1	1	1	0	3
OG0012246	1	1	1	0	3
OG0012247	1	1	1	0	3
OG0012248	2	1	0	0	3
OG0012249	1	1	1	0	3
OG0012250	1	1	1	0	3
OG0012251	1	1	1	0	3
OG0012252	1	1	1	0	3
OG0012253	1	1	1	0	3
OG0012254	1	1	1	0	3
OG0012255	1	1	1	0	3
OG0012256	1	1	1	0	3
OG0012257	1	1	1	0	3
OG0012258	1	1	1	0	3
OG0012259	1	1	1	0	3
OG0012260	1	1	1	0	3
OG0012261	1	1	1	0	3
OG0012262	1	1	1	0	3
OG0012263	1	1	1	0	3
OG0012264	3	0	0	0	3
OG0012265	1	0	2	0	3
OG0012266	1	1	1	0	3
OG0012267	1	1	1	0	3
OG0012268	1	1	1	0	3
OG0012269	1	1	1	0	3
OG0012270	1	1	1	0	3
OG0012271	2	1	0	0	3
OG0012272	1	0	1	1	3
OG0012273	1	1	1	0	3
OG0012274	1	0	1	1	3
OG0012275	1	1	1	0	3
OG0012276	1	0	1	1	3
OG0012277	1	1	1	0	3
OG0012278	1	1	1	0	3
OG0012279	1	1	1	0	3
OG0012280	1	1	1	0	3
OG0012281	1	1	1	0	3
OG0012282	1	1	1	0	3
OG0012283	1	1	1	0	3
OG0012284	1	1	1	0	3
OG0012285	1	1	1	0	3
OG0012286	1	1	1	0	3
OG0012287	1	0	1	1	3
OG0012288	1	1	1	0	3
OG0012289	1	1	1	0	3
OG0012290	1	1	1	0	3
OG0012291	1	1	1	0	3
OG0012292	1	0	2	0	3
OG0012293	1	1	1	0	3
OG0012294	1	1	1	0	3
OG0012295	1	1	1	0	3
OG0012296	1	1	1	0	3
OG0012297	1	1	1	0	3
OG0012298	1	1	1	0	3
OG0012299	1	1	1	0	3
OG0012300	1	1	1	0	3
OG0012301	1	1	1	0	3
OG0012302	1	1	1	0	3
OG0012303	1	1	1	0	3
OG0012304	1	1	1	0	3
OG0012305	1	1	1	0	3
OG0012306	1	1	1	0	3
OG0012307	1	1	1	0	3
OG0012308	1	1	1	0	3
OG0012309	1	1	1	0	3
OG0012310	2	1	0	0	3
OG0012311	1	1	1	0	3
OG0012312	1	1	1	0	3
OG0012313	1	1	1	0	3
OG0012314	1	1	1	0	3
OG0012315	1	1	1	0	3
OG0012316	1	1	1	0	3
OG0012317	1	1	1	0	3
OG0012318	1	1	1	0	3
OG0012319	1	1	1	0	3
OG0012320	1	1	1	0	3
OG0012321	1	1	1	0	3
OG0012322	1	1	1	0	3
OG0012323	1	1	1	0	3
OG0012324	1	1	1	0	3
OG0012325	1	1	1	0	3
OG0012326	1	1	1	0	3
OG0012327	1	1	1	0	3
OG0012328	1	1	1	0	3
OG0012329	1	1	0	1	3
OG0012330	1	1	1	0	3
OG0012331	1	1	1	0	3
OG0012332	3	0	0	0	3
OG0012333	1	1	1	0	3
OG0012334	3	0	0	0	3
OG0012335	1	1	1	0	3
OG0012336	1	1	1	0	3
OG0012337	2	1	0	0	3
OG0012338	1	1	1	0	3
OG0012339	3	0	0	0	3
OG0012340	1	1	1	0	3
OG0012341	3	0	0	0	3
OG0012342	1	1	1	0	3
OG0012343	1	1	1	0	3
OG0012344	1	1	1	0	3
OG0012345	1	0	1	1	3
OG0012346	1	0	1	1	3
OG0012347	1	1	1	0	3
OG0012348	1	1	1	0	3
OG0012349	1	1	1	0	3
OG0012350	1	1	1	0	3
OG0012351	1	1	0	1	3
OG0012352	1	1	0	1	3
OG0012353	1	1	1	0	3
OG0012354	1	1	1	0	3
OG0012355	1	1	1	0	3
OG0012356	1	1	1	0	3
OG0012357	1	1	1	0	3
OG0012358	1	1	1	0	3
OG0012359	1	1	1	0	3
OG0012360	1	1	1	0	3
OG0012361	1	1	1	0	3
OG0012362	1	1	1	0	3
OG0012363	1	1	1	0	3
OG0012364	1	1	1	0	3
OG0012365	1	1	1	0	3
OG0012366	1	1	1	0	3
OG0012367	1	1	1	0	3
OG0012368	2	0	1	0	3
OG0012369	1	1	1	0	3
OG0012370	1	0	2	0	3
OG0012371	1	1	1	0	3
OG0012372	1	1	1	0	3
OG0012373	1	1	1	0	3
OG0012374	1	1	1	0	3
OG0012375	3	0	0	0	3
OG0012376	1	1	1	0	3
OG0012377	1	1	1	0	3
OG0012378	1	1	1	0	3
OG0012379	1	1	1	0	3
OG0012380	1	1	1	0	3
OG0012381	1	1	1	0	3
OG0012382	1	1	1	0	3
OG0012383	1	1	1	0	3
OG0012384	1	1	1	0	3
OG0012385	1	1	1	0	3
OG0012386	1	1	1	0	3
OG0012387	1	1	1	0	3
OG0012388	2	1	0	0	3
OG0012389	1	1	1	0	3
OG0012390	1	1	1	0	3
OG0012391	1	1	1	0	3
OG0012392	1	1	1	0	3
OG0012393	1	1	1	0	3
OG0012394	1	0	1	1	3
OG0012395	1	1	1	0	3
OG0012396	1	1	1	0	3
OG0012397	3	0	0	0	3
OG0012398	1	1	1	0	3
OG0012399	1	1	1	0	3
OG0012400	1	1	1	0	3
OG0012401	1	1	1	0	3
OG0012402	1	1	1	0	3
OG0012403	1	1	1	0	3
OG0012404	1	1	1	0	3
OG0012405	1	1	1	0	3
OG0012406	3	0	0	0	3
OG0012407	1	1	1	0	3
OG0012408	1	1	1	0	3
OG0012409	1	1	1	0	3
OG0012410	1	2	0	0	3
OG0012411	1	1	1	0	3
OG0012412	1	1	1	0	3
OG0012413	1	1	1	0	3
OG0012414	1	1	1	0	3
OG0012415	1	1	1	0	3
OG0012416	1	1	1	0	3
OG0012417	1	1	1	0	3
OG0012418	1	1	1	0	3
OG0012419	1	1	1	0	3
OG0012420	1	1	1	0	3
OG0012421	1	1	1	0	3
OG0012422	1	1	1	0	3
OG0012423	1	1	1	0	3
OG0012424	1	1	1	0	3
OG0012425	1	1	1	0	3
OG0012426	1	1	1	0	3
OG0012427	2	1	0	0	3
OG0012428	1	1	1	0	3
OG0012429	1	1	1	0	3
OG0012430	1	2	0	0	3
OG0012431	1	1	1	0	3
OG0012432	1	1	1	0	3
OG0012433	1	1	1	0	3
OG0012434	1	1	1	0	3
OG0012435	1	1	1	0	3
OG0012436	1	1	1	0	3
OG0012437	1	1	1	0	3
OG0012438	1	0	1	1	3
OG0012439	1	1	1	0	3
OG0012440	1	1	1	0	3
OG0012441	1	1	1	0	3
OG0012442	1	1	1	0	3
OG0012443	1	1	1	0	3
OG0012444	1	1	1	0	3
OG0012445	1	1	1	0	3
OG0012446	1	1	1	0	3
OG0012447	1	1	1	0	3
OG0012448	1	1	1	0	3
OG0012449	1	1	1	0	3
OG0012450	1	2	0	0	3
OG0012451	1	1	1	0	3
OG0012452	1	1	1	0	3
OG0012453	2	0	1	0	3
OG0012454	1	1	1	0	3
OG0012455	1	1	1	0	3
OG0012456	1	0	1	1	3
OG0012457	1	1	1	0	3
OG0012458	1	1	1	0	3
OG0012459	1	1	0	1	3
OG0012460	2	1	0	0	3
OG0012461	1	1	1	0	3
OG0012462	1	1	1	0	3
OG0012463	1	1	1	0	3
OG0012464	1	1	1	0	3
OG0012465	1	1	1	0	3
OG0012466	1	1	1	0	3
OG0012467	1	1	1	0	3
OG0012468	1	1	0	1	3
OG0012469	1	1	1	0	3
OG0012470	1	1	1	0	3
OG0012471	1	1	1	0	3
OG0012472	1	1	1	0	3
OG0012473	1	1	1	0	3
OG0012474	1	1	1	0	3
OG0012475	1	1	1	0	3
OG0012476	1	1	1	0	3
OG0012477	1	1	1	0	3
OG0012478	1	1	1	0	3
OG0012479	3	0	0	0	3
OG0012480	1	1	1	0	3
OG0012481	1	1	1	0	3
OG0012482	1	1	1	0	3
OG0012483	1	1	1	0	3
OG0012484	1	1	1	0	3
OG0012485	1	1	1	0	3
OG0012486	1	1	0	1	3
OG0012487	1	1	1	0	3
OG0012488	1	1	1	0	3
OG0012489	1	1	1	0	3
OG0012490	1	1	1	0	3
OG0012491	2	1	0	0	3
OG0012492	1	0	2	0	3
OG0012493	2	1	0	0	3
OG0012494	1	1	1	0	3
OG0012495	1	1	1	0	3
OG0012496	1	1	1	0	3
OG0012497	1	1	1	0	3
OG0012498	1	1	0	1	3
OG0012499	1	1	1	0	3
OG0012500	1	1	1	0	3
OG0012501	2	1	0	0	3
OG0012502	1	1	1	0	3
OG0012503	1	1	1	0	3
OG0012504	1	1	1	0	3
OG0012505	1	1	1	0	3
OG0012506	1	1	1	0	3
OG0012507	1	1	1	0	3
OG0012508	1	1	1	0	3
OG0012509	3	0	0	0	3
OG0012510	1	1	1	0	3
OG0012511	1	1	1	0	3
OG0012512	1	1	1	0	3
OG0012513	1	1	1	0	3
OG0012514	1	1	1	0	3
OG0012515	1	1	1	0	3
OG0012516	1	1	1	0	3
OG0012517	1	1	1	0	3
OG0012518	1	1	1	0	3
OG0012519	1	1	1	0	3
OG0012520	1	1	1	0	3
OG0012521	1	1	1	0	3
OG0012522	1	1	1	0	3
OG0012523	3	0	0	0	3
OG0012524	2	1	0	0	3
OG0012525	1	1	1	0	3
OG0012526	1	1	1	0	3
OG0012527	1	1	1	0	3
OG0012528	1	1	1	0	3
OG0012529	1	2	0	0	3
OG0012530	1	1	1	0	3
OG0012531	1	1	1	0	3
OG0012532	1	1	1	0	3
OG0012533	1	0	2	0	3
OG0012534	1	1	1	0	3
OG0012535	3	0	0	0	3
OG0012536	1	1	1	0	3
OG0012537	1	0	1	1	3
OG0012538	1	1	1	0	3
OG0012539	1	1	1	0	3
OG0012540	1	1	1	0	3
OG0012541	1	0	1	1	3
OG0012542	1	1	1	0	3
OG0012543	1	2	0	0	3
OG0012544	2	1	0	0	3
OG0012545	1	1	1	0	3
OG0012546	1	1	1	0	3
OG0012547	1	1	1	0	3
OG0012548	1	1	0	1	3
OG0012549	1	1	1	0	3
OG0012550	1	0	1	1	3
OG0012551	1	1	1	0	3
OG0012552	1	1	1	0	3
OG0012553	1	1	1	0	3
OG0012554	1	1	1	0	3
OG0012555	1	1	0	1	3
OG0012556	1	1	1	0	3
OG0012557	1	1	0	1	3
OG0012558	1	1	1	0	3
OG0012559	1	1	1	0	3
OG0012560	1	1	1	0	3
OG0012561	1	1	1	0	3
OG0012562	1	1	1	0	3
OG0012563	1	1	1	0	3
OG0012564	1	1	1	0	3
OG0012565	1	1	1	0	3
OG0012566	1	1	1	0	3
OG0012567	1	1	1	0	3
OG0012568	1	1	1	0	3
OG0012569	1	1	1	0	3
OG0012570	1	1	1	0	3
OG0012571	1	1	1	0	3
OG0012572	2	1	0	0	3
OG0012573	1	1	1	0	3
OG0012574	1	1	1	0	3
OG0012575	1	1	1	0	3
OG0012576	1	1	1	0	3
OG0012577	1	1	1	0	3
OG0012578	3	0	0	0	3
OG0012579	1	1	1	0	3
OG0012580	1	0	2	0	3
OG0012581	1	1	1	0	3
OG0012582	1	1	1	0	3
OG0012583	1	1	1	0	3
OG0012584	1	1	0	1	3
OG0012585	1	1	1	0	3
OG0012586	1	1	1	0	3
OG0012587	3	0	0	0	3
OG0012588	1	1	1	0	3
OG0012589	1	1	0	1	3
OG0012590	1	1	1	0	3
OG0012591	1	1	1	0	3
OG0012592	1	1	1	0	3
OG0012593	1	1	1	0	3
OG0012594	1	1	1	0	3
OG0012595	1	1	1	0	3
OG0012596	2	0	1	0	3
OG0012597	1	1	1	0	3
OG0012598	1	0	0	2	3
OG0012599	3	0	0	0	3
OG0012600	1	1	1	0	3
OG0012601	1	1	1	0	3
OG0012602	1	2	0	0	3
OG0012603	1	1	1	0	3
OG0012604	1	1	1	0	3
OG0012605	1	0	2	0	3
OG0012606	1	1	1	0	3
OG0012607	1	1	1	0	3
OG0012608	1	1	1	0	3
OG0012609	1	0	2	0	3
OG0012610	1	2	0	0	3
OG0012611	3	0	0	0	3
OG0012612	1	1	1	0	3
OG0012613	1	1	1	0	3
OG0012614	3	0	0	0	3
OG0012615	1	1	1	0	3
OG0012616	1	0	1	1	3
OG0012617	1	1	1	0	3
OG0012618	1	1	1	0	3
OG0012619	3	0	0	0	3
OG0012620	1	1	0	1	3
OG0012621	1	1	1	0	3
OG0012622	1	1	1	0	3
OG0012623	2	0	1	0	3
OG0012624	1	1	1	0	3
OG0012625	1	1	1	0	3
OG0012626	1	1	1	0	3
OG0012627	2	1	0	0	3
OG0012628	1	1	1	0	3
OG0012629	1	1	1	0	3
OG0012630	1	1	1	0	3
OG0012631	1	1	1	0	3
OG0012632	1	1	1	0	3
OG0012633	1	0	1	1	3
OG0012634	1	1	1	0	3
OG0012635	1	1	1	0	3
OG0012636	1	1	1	0	3
OG0012637	1	1	1	0	3
OG0012638	1	1	1	0	3
OG0012639	3	0	0	0	3
OG0012640	1	1	1	0	3
OG0012641	1	1	1	0	3
OG0012642	1	1	0	1	3
OG0012643	3	0	0	0	3
OG0012644	3	0	0	0	3
OG0012645	1	1	1	0	3
OG0012646	1	1	1	0	3
OG0012647	1	1	1	0	3
OG0012648	1	1	1	0	3
OG0012649	1	1	1	0	3
OG0012650	1	1	1	0	3
OG0012651	1	1	1	0	3
OG0012652	1	1	1	0	3
OG0012653	2	1	0	0	3
OG0012654	2	0	1	0	3
OG0012655	1	1	1	0	3
OG0012656	1	1	1	0	3
OG0012657	1	1	1	0	3
OG0012658	2	1	0	0	3
OG0012659	1	1	1	0	3
OG0012660	1	1	1	0	3
OG0012661	1	1	1	0	3
OG0012662	1	1	1	0	3
OG0012663	1	0	1	1	3
OG0012664	1	1	1	0	3
OG0012665	1	1	1	0	3
OG0012666	1	1	1	0	3
OG0012667	1	1	1	0	3
OG0012668	1	1	1	0	3
OG0012669	1	1	1	0	3
OG0012670	1	1	1	0	3
OG0012671	1	1	1	0	3
OG0012672	1	1	1	0	3
OG0012673	1	1	1	0	3
OG0012674	1	1	1	0	3
OG0012675	1	1	0	1	3
OG0012676	1	1	1	0	3
OG0012677	1	1	1	0	3
OG0012678	1	1	1	0	3
OG0012679	1	1	1	0	3
OG0012680	1	1	1	0	3
OG0012681	1	1	1	0	3
OG0012682	1	1	1	0	3
OG0012683	1	0	1	1	3
OG0012684	1	0	1	1	3
OG0012685	1	1	1	0	3
OG0012686	1	0	1	1	3
OG0012687	1	1	1	0	3
OG0012688	1	0	1	1	3
OG0012689	1	1	1	0	3
OG0012690	1	1	1	0	3
OG0012691	2	0	1	0	3
OG0012692	1	0	1	1	3
OG0012693	1	1	1	0	3
OG0012694	1	1	1	0	3
OG0012695	1	1	1	0	3
OG0012696	1	1	1	0	3
OG0012697	1	1	1	0	3
OG0012698	1	1	1	0	3
OG0012699	2	1	0	0	3
OG0012700	1	1	1	0	3
OG0012701	1	1	0	1	3
OG0012702	1	1	1	0	3
OG0012703	1	1	1	0	3
OG0012704	1	1	0	1	3
OG0012705	1	1	1	0	3
OG0012706	1	1	1	0	3
OG0012707	1	2	0	0	3
OG0012708	1	1	1	0	3
OG0012709	1	1	1	0	3
OG0012710	1	1	1	0	3
OG0012711	1	1	1	0	3
OG0012712	1	1	1	0	3
OG0012713	1	1	1	0	3
OG0012714	1	1	1	0	3
OG0012715	1	1	1	0	3
OG0012716	3	0	0	0	3
OG0012717	1	1	1	0	3
OG0012718	3	0	0	0	3
OG0012719	1	1	1	0	3
OG0012720	1	1	0	1	3
OG0012721	1	1	1	0	3
OG0012722	1	1	1	0	3
OG0012723	1	1	1	0	3
OG0012724	1	1	1	0	3
OG0012725	3	0	0	0	3
OG0012726	1	1	1	0	3
OG0012727	2	1	0	0	3
OG0012728	1	1	1	0	3
OG0012729	1	1	1	0	3
OG0012730	1	1	1	0	3
OG0012731	1	1	1	0	3
OG0012732	1	1	1	0	3
OG0012733	1	1	1	0	3
OG0012734	1	1	1	0	3
OG0012735	1	0	2	0	3
OG0012736	1	1	1	0	3
OG0012737	1	1	1	0	3
OG0012738	1	1	1	0	3
OG0012739	2	0	1	0	3
OG0012740	1	0	2	0	3
OG0012741	1	1	1	0	3
OG0012742	1	1	1	0	3
OG0012743	3	0	0	0	3
OG0012744	3	0	0	0	3
OG0012745	1	1	1	0	3
OG0012746	1	1	0	1	3
OG0012747	1	1	1	0	3
OG0012748	1	1	1	0	3
OG0012749	1	1	1	0	3
OG0012750	1	1	1	0	3
OG0012751	3	0	0	0	3
OG0012752	1	1	1	0	3
OG0012753	1	1	1	0	3
OG0012754	1	1	1	0	3
OG0012755	1	0	1	1	3
OG0012756	1	1	1	0	3
OG0012757	1	1	1	0	3
OG0012758	1	1	1	0	3
OG0012759	1	1	1	0	3
OG0012760	1	1	1	0	3
OG0012761	1	1	1	0	3
OG0012762	1	1	1	0	3
OG0012763	1	1	1	0	3
OG0012764	1	1	1	0	3
OG0012765	1	1	1	0	3
OG0012766	1	1	1	0	3
OG0012767	3	0	0	0	3
OG0012768	1	1	1	0	3
OG0012769	1	1	1	0	3
OG0012770	1	1	1	0	3
OG0012771	1	1	0	1	3
OG0012772	1	1	1	0	3
OG0012773	2	1	0	0	3
OG0012774	1	1	1	0	3
OG0012775	1	1	1	0	3
OG0012776	1	1	1	0	3
OG0012777	1	1	1	0	3
OG0012778	1	1	1	0	3
OG0012779	1	1	1	0	3
OG0012780	1	1	1	0	3
OG0012781	1	1	1	0	3
OG0012782	1	1	1	0	3
OG0012783	1	1	1	0	3
OG0012784	1	0	1	1	3
OG0012785	1	1	1	0	3
OG0012786	1	1	1	0	3
OG0012787	1	1	0	1	3
OG0012788	1	1	1	0	3
OG0012789	2	0	1	0	3
OG0012790	3	0	0	0	3
OG0012791	1	1	1	0	3
OG0012792	1	1	1	0	3
OG0012793	1	1	1	0	3
OG0012794	3	0	0	0	3
OG0012795	1	1	1	0	3
OG0012796	1	1	0	1	3
OG0012797	1	1	0	1	3
OG0012798	1	1	1	0	3
OG0012799	1	1	1	0	3
OG0012800	1	1	1	0	3
OG0012801	1	1	1	0	3
OG0012802	1	1	1	0	3
OG0012803	1	1	1	0	3
OG0012804	1	1	1	0	3
OG0012805	1	1	1	0	3
OG0012806	1	0	1	1	3
OG0012807	1	1	1	0	3
OG0012808	1	1	1	0	3
OG0012809	1	1	1	0	3
OG0012810	1	1	1	0	3
OG0012811	1	1	1	0	3
OG0012812	1	1	1	0	3
OG0012813	1	1	1	0	3
OG0012814	1	1	1	0	3
OG0012815	1	1	1	0	3
OG0012816	1	1	1	0	3
OG0012817	1	1	1	0	3
OG0012818	1	1	1	0	3
OG0012819	1	1	1	0	3
OG0012820	1	1	1	0	3
OG0012821	1	2	0	0	3
OG0012822	1	1	1	0	3
OG0012823	1	1	1	0	3
OG0012824	1	1	1	0	3
OG0012825	1	1	1	0	3
OG0012826	1	1	1	0	3
OG0012827	1	1	1	0	3
OG0012828	3	0	0	0	3
OG0012829	1	1	1	0	3
OG0012830	1	1	1	0	3
OG0012831	1	1	1	0	3
OG0012832	1	1	1	0	3
OG0012833	1	1	1	0	3
OG0012834	1	1	1	0	3
OG0012835	1	1	1	0	3
OG0012836	1	1	1	0	3
OG0012837	1	1	1	0	3
OG0012838	1	1	1	0	3
OG0012839	1	1	1	0	3
OG0012840	1	1	1	0	3
OG0012841	1	1	1	0	3
OG0012842	2	1	0	0	3
OG0012843	1	1	1	0	3
OG0012844	1	0	1	1	3
OG0012845	1	1	1	0	3
OG0012846	1	0	2	0	3
OG0012847	1	0	2	0	3
OG0012848	1	1	1	0	3
OG0012849	1	1	1	0	3
OG0012850	1	1	1	0	3
OG0012851	2	1	0	0	3
OG0012852	1	1	1	0	3
OG0012853	1	1	1	0	3
OG0012854	1	1	1	0	3
OG0012855	1	1	0	1	3
OG0012856	1	0	1	1	3
OG0012857	1	1	1	0	3
OG0012858	1	1	1	0	3
OG0012859	1	1	1	0	3
OG0012860	1	1	1	0	3
OG0012861	1	1	1	0	3
OG0012862	1	1	1	0	3
OG0012863	1	1	1	0	3
OG0012864	1	0	1	1	3
OG0012865	1	1	1	0	3
OG0012866	1	1	1	0	3
OG0012867	1	1	1	0	3
OG0012868	1	0	2	0	3
OG0012869	1	2	0	0	3
OG0012870	1	1	1	0	3
OG0012871	1	1	1	0	3
OG0012872	1	1	1	0	3
OG0012873	1	1	1	0	3
OG0012874	1	0	2	0	3
OG0012875	1	1	1	0	3
OG0012876	1	0	1	1	3
OG0012877	1	1	0	1	3
OG0012878	1	1	1	0	3
OG0012879	1	1	1	0	3
OG0012880	1	1	1	0	3
OG0012881	1	1	1	0	3
OG0012882	1	1	1	0	3
OG0012883	1	1	1	0	3
OG0012884	1	1	1	0	3
OG0012885	2	0	1	0	3
OG0012886	1	2	0	0	3
OG0012887	1	1	1	0	3
OG0012888	2	1	0	0	3
OG0012889	1	1	1	0	3
OG0012890	1	0	1	1	3
OG0012891	1	1	1	0	3
OG0012892	1	1	1	0	3
OG0012893	1	1	1	0	3
OG0012894	1	1	1	0	3
OG0012895	1	1	1	0	3
OG0012896	1	1	1	0	3
OG0012897	1	1	0	1	3
OG0012898	1	1	1	0	3
OG0012899	1	1	1	0	3
OG0012900	1	1	1	0	3
OG0012901	1	1	1	0	3
OG0012902	1	2	0	0	3
OG0012903	2	1	0	0	3
OG0012904	1	0	1	1	3
OG0012905	1	1	1	0	3
OG0012906	1	1	1	0	3
OG0012907	1	1	1	0	3
OG0012908	1	1	1	0	3
OG0012909	1	1	1	0	3
OG0012910	1	1	1	0	3
OG0012911	1	1	1	0	3
OG0012912	1	1	1	0	3
OG0012913	1	1	1	0	3
OG0012914	1	1	1	0	3
OG0012915	1	1	1	0	3
OG0012916	1	1	1	0	3
OG0012917	1	1	1	0	3
OG0012918	1	1	1	0	3
OG0012919	1	1	1	0	3
OG0012920	2	1	0	0	3
OG0012921	1	1	1	0	3
OG0012922	1	1	1	0	3
OG0012923	1	0	1	1	3
OG0012924	1	1	1	0	3
OG0012925	1	1	1	0	3
OG0012926	1	1	1	0	3
OG0012927	1	1	1	0	3
OG0012928	1	1	1	0	3
OG0012929	1	1	1	0	3
OG0012930	1	1	1	0	3
OG0012931	1	1	0	1	3
OG0012932	1	1	1	0	3
OG0012933	1	1	1	0	3
OG0012934	1	1	1	0	3
OG0012935	1	1	1	0	3
OG0012936	1	1	1	0	3
OG0012937	1	1	1	0	3
OG0012938	1	0	2	0	3
OG0012939	1	1	1	0	3
OG0012940	1	1	1	0	3
OG0012941	1	1	1	0	3
OG0012942	1	1	0	1	3
OG0012943	1	1	1	0	3
OG0012944	1	1	1	0	3
OG0012945	1	1	1	0	3
OG0012946	1	1	1	0	3
OG0012947	1	1	1	0	3
OG0012948	1	1	1	0	3
OG0012949	1	1	1	0	3
OG0012950	1	1	1	0	3
OG0012951	1	1	1	0	3
OG0012952	1	1	1	0	3
OG0012953	1	1	1	0	3
OG0012954	1	1	1	0	3
OG0012955	1	1	1	0	3
OG0012956	1	1	1	0	3
OG0012957	2	0	0	1	3
OG0012958	1	2	0	0	3
OG0012959	1	1	1	0	3
OG0012960	1	1	1	0	3
OG0012961	1	1	0	1	3
OG0012962	1	1	1	0	3
OG0012963	1	1	1	0	3
OG0012964	1	1	1	0	3
OG0012965	1	1	1	0	3
OG0012966	1	1	1	0	3
OG0012967	1	1	1	0	3
OG0012968	1	1	1	0	3
OG0012969	1	1	1	0	3
OG0012970	1	1	1	0	3
OG0012971	1	1	1	0	3
OG0012972	1	1	1	0	3
OG0012973	1	1	1	0	3
OG0012974	1	0	2	0	3
OG0012975	1	1	1	0	3
OG0012976	1	0	2	0	3
OG0012977	1	1	1	0	3
OG0012978	1	2	0	0	3
OG0012979	1	1	1	0	3
OG0012980	1	1	1	0	3
OG0012981	1	1	1	0	3
OG0012982	1	1	1	0	3
OG0012983	1	1	1	0	3
OG0012984	1	1	0	1	3
OG0012985	3	0	0	0	3
OG0012986	1	1	1	0	3
OG0012987	1	1	1	0	3
OG0012988	1	0	2	0	3
OG0012989	1	1	1	0	3
OG0012990	1	1	1	0	3
OG0012991	1	1	1	0	3
OG0012992	2	1	0	0	3
OG0012993	1	2	0	0	3
OG0012994	1	1	1	0	3
OG0012995	1	1	1	0	3
OG0012996	1	1	1	0	3
OG0012997	1	1	0	1	3
OG0012998	1	1	1	0	3
OG0012999	1	1	0	1	3
OG0013000	1	1	1	0	3
OG0013001	1	1	1	0	3
OG0013002	1	1	1	0	3
OG0013003	1	1	1	0	3
OG0013004	1	1	1	0	3
OG0013005	1	0	1	1	3
OG0013006	2	1	0	0	3
OG0013007	1	1	1	0	3
OG0013008	1	1	1	0	3
OG0013009	1	1	1	0	3
OG0013010	1	1	1	0	3
OG0013011	1	1	1	0	3
OG0013012	1	1	1	0	3
OG0013013	1	1	1	0	3
OG0013014	1	1	1	0	3
OG0013015	1	1	1	0	3
OG0013016	1	1	1	0	3
OG0013017	1	1	1	0	3
OG0013018	1	1	1	0	3
OG0013019	1	1	1	0	3
OG0013020	1	1	1	0	3
OG0013021	1	1	1	0	3
OG0013022	1	0	1	1	3
OG0013023	1	1	1	0	3
OG0013024	1	1	0	1	3
OG0013025	1	1	1	0	3
OG0013026	1	1	1	0	3
OG0013027	1	1	1	0	3
OG0013028	1	1	1	0	3
OG0013029	1	2	0	0	3
OG0013030	1	1	1	0	3
OG0013031	1	1	1	0	3
OG0013032	1	1	1	0	3
OG0013033	1	1	1	0	3
OG0013034	1	0	2	0	3
OG0013035	1	1	1	0	3
OG0013036	1	1	1	0	3
OG0013037	1	1	0	1	3
OG0013038	1	1	1	0	3
OG0013039	1	1	1	0	3
OG0013040	1	1	1	0	3
OG0013041	2	0	1	0	3
OG0013042	3	0	0	0	3
OG0013043	1	1	1	0	3
OG0013044	1	1	0	1	3
OG0013045	1	1	1	0	3
OG0013046	1	1	1	0	3
OG0013047	1	1	1	0	3
OG0013048	1	0	2	0	3
OG0013049	1	1	1	0	3
OG0013050	1	1	1	0	3
OG0013051	1	1	1	0	3
OG0013052	1	1	1	0	3
OG0013053	1	1	1	0	3
OG0013054	1	1	1	0	3
OG0013055	1	1	1	0	3
OG0013056	1	1	1	0	3
OG0013057	1	1	1	0	3
OG0013058	2	0	1	0	3
OG0013059	1	1	1	0	3
OG0013060	1	1	1	0	3
OG0013061	1	1	1	0	3
OG0013062	1	1	1	0	3
OG0013063	1	1	1	0	3
OG0013064	1	1	1	0	3
OG0013065	1	2	0	0	3
OG0013066	1	1	0	1	3
OG0013067	1	1	1	0	3
OG0013068	2	1	0	0	3
OG0013069	1	1	1	0	3
OG0013070	1	1	1	0	3
OG0013071	3	0	0	0	3
OG0013072	1	1	1	0	3
OG0013073	1	1	1	0	3
OG0013074	1	1	1	0	3
OG0013075	1	1	1	0	3
OG0013076	1	1	1	0	3
OG0013077	1	1	0	1	3
OG0013078	1	1	1	0	3
OG0013079	1	1	1	0	3
OG0013080	1	1	1	0	3
OG0013081	1	1	1	0	3
OG0013082	1	0	2	0	3
OG0013083	1	1	1	0	3
OG0013084	1	1	1	0	3
OG0013085	1	1	1	0	3
OG0013086	1	1	1	0	3
OG0013087	1	1	1	0	3
OG0013088	1	1	1	0	3
OG0013089	1	1	1	0	3
OG0013090	1	0	1	1	3
OG0013091	1	0	1	1	3
OG0013092	1	1	0	1	3
OG0013093	2	1	0	0	3
OG0013094	1	1	1	0	3
OG0013095	1	1	1	0	3
OG0013096	1	1	1	0	3
OG0013097	1	1	1	0	3
OG0013098	1	1	1	0	3
OG0013099	1	1	1	0	3
OG0013100	1	1	1	0	3
OG0013101	1	1	1	0	3
OG0013102	1	1	1	0	3
OG0013103	1	1	1	0	3
OG0013104	1	1	1	0	3
OG0013105	1	1	1	0	3
OG0013106	1	1	1	0	3
OG0013107	1	1	1	0	3
OG0013108	1	1	1	0	3
OG0013109	1	1	1	0	3
OG0013110	1	1	1	0	3
OG0013111	1	1	1	0	3
OG0013112	1	1	1	0	3
OG0013113	1	1	1	0	3
OG0013114	1	1	1	0	3
OG0013115	1	1	1	0	3
OG0013116	1	1	1	0	3
OG0013117	1	1	1	0	3
OG0013118	1	0	2	0	3
OG0013119	1	1	1	0	3
OG0013120	1	1	1	0	3
OG0013121	2	1	0	0	3
OG0013122	1	1	1	0	3
OG0013123	1	1	1	0	3
OG0013124	1	1	1	0	3
OG0013125	1	1	1	0	3
OG0013126	1	1	1	0	3
OG0013127	1	1	1	0	3
OG0013128	1	0	1	1	3
OG0013129	1	1	0	1	3
OG0013130	1	1	1	0	3
OG0013131	1	1	1	0	3
OG0013132	1	1	1	0	3
OG0013133	1	1	1	0	3
OG0013134	1	0	1	1	3
OG0013135	1	1	1	0	3
OG0013136	1	1	1	0	3
OG0013137	1	1	1	0	3
OG0013138	1	1	1	0	3
OG0013139	1	1	1	0	3
OG0013140	1	1	1	0	3
OG0013141	1	1	1	0	3
OG0013142	1	1	1	0	3
OG0013143	1	1	1	0	3
OG0013144	1	1	1	0	3
OG0013145	1	1	1	0	3
OG0013146	1	1	1	0	3
OG0013147	1	1	1	0	3
OG0013148	1	1	1	0	3
OG0013149	1	2	0	0	3
OG0013150	1	1	1	0	3
OG0013151	1	1	1	0	3
OG0013152	1	1	1	0	3
OG0013153	1	1	1	0	3
OG0013154	1	1	1	0	3
OG0013155	1	1	1	0	3
OG0013156	1	1	1	0	3
OG0013157	1	1	1	0	3
OG0013158	1	1	1	0	3
OG0013159	1	1	0	1	3
OG0013160	1	1	0	1	3
OG0013161	1	1	1	0	3
OG0013162	3	0	0	0	3
OG0013163	1	1	1	0	3
OG0013164	1	1	1	0	3
OG0013165	1	1	1	0	3
OG0013166	1	1	1	0	3
OG0013167	1	1	0	1	3
OG0013168	1	1	1	0	3
OG0013169	1	1	1	0	3
OG0013170	1	1	0	1	3
OG0013171	1	1	1	0	3
OG0013172	1	1	1	0	3
OG0013173	1	1	1	0	3
OG0013174	1	1	1	0	3
OG0013175	1	1	1	0	3
OG0013176	1	1	1	0	3
OG0013177	1	2	0	0	3
OG0013178	1	1	1	0	3
OG0013179	1	1	1	0	3
OG0013180	1	1	1	0	3
OG0013181	1	1	1	0	3
OG0013182	1	2	0	0	3
OG0013183	1	1	1	0	3
OG0013184	1	1	1	0	3
OG0013185	1	1	0	1	3
OG0013186	1	1	1	0	3
OG0013187	1	1	1	0	3
OG0013188	1	1	1	0	3
OG0013189	1	1	1	0	3
OG0013190	1	1	1	0	3
OG0013191	1	1	1	0	3
OG0013192	1	1	1	0	3
OG0013193	1	1	1	0	3
OG0013194	1	2	0	0	3
OG0013195	1	1	1	0	3
OG0013196	1	1	1	0	3
OG0013197	1	1	1	0	3
OG0013198	1	1	1	0	3
OG0013199	1	1	1	0	3
OG0013200	1	1	1	0	3
OG0013201	1	1	1	0	3
OG0013202	1	1	1	0	3
OG0013203	1	1	1	0	3
OG0013204	1	1	1	0	3
OG0013205	1	1	1	0	3
OG0013206	1	1	1	0	3
OG0013207	1	1	1	0	3
OG0013208	1	1	1	0	3
OG0013209	1	1	1	0	3
OG0013210	1	1	1	0	3
OG0013211	1	1	1	0	3
OG0013212	1	2	0	0	3
OG0013213	1	1	0	1	3
OG0013214	1	1	1	0	3
OG0013215	1	1	1	0	3
OG0013216	1	1	1	0	3
OG0013217	1	1	1	0	3
OG0013218	3	0	0	0	3
OG0013219	1	1	1	0	3
OG0013220	1	1	1	0	3
OG0013221	1	1	1	0	3
OG0013222	1	1	1	0	3
OG0013223	1	1	1	0	3
OG0013224	1	1	1	0	3
OG0013225	1	0	2	0	3
OG0013226	1	1	1	0	3
OG0013227	1	1	1	0	3
OG0013228	1	1	1	0	3
OG0013229	1	1	1	0	3
OG0013230	1	1	0	1	3
OG0013231	1	1	1	0	3
OG0013232	1	1	1	0	3
OG0013233	1	1	1	0	3
OG0013234	1	1	1	0	3
OG0013235	1	1	1	0	3
OG0013236	1	1	1	0	3
OG0013237	1	1	1	0	3
OG0013238	1	1	1	0	3
OG0013239	1	1	1	0	3
OG0013240	1	1	1	0	3
OG0013241	1	1	1	0	3
OG0013242	1	1	1	0	3
OG0013243	1	1	1	0	3
OG0013244	1	1	1	0	3
OG0013245	1	1	1	0	3
OG0013246	1	1	1	0	3
OG0013247	1	1	0	1	3
OG0013248	1	1	1	0	3
OG0013249	1	1	1	0	3
OG0013250	1	1	1	0	3
OG0013251	1	1	1	0	3
OG0013252	1	1	1	0	3
OG0013253	1	1	1	0	3
OG0013254	1	1	1	0	3
OG0013255	1	1	1	0	3
OG0013256	1	1	1	0	3
OG0013257	1	1	1	0	3
OG0013258	1	1	1	0	3
OG0013259	1	1	1	0	3
OG0013260	1	1	1	0	3
OG0013261	1	1	1	0	3
OG0013262	1	1	1	0	3
OG0013263	1	1	1	0	3
OG0013264	1	1	1	0	3
OG0013265	1	0	2	0	3
OG0013266	1	1	1	0	3
OG0013267	1	1	1	0	3
OG0013268	1	1	1	0	3
OG0013269	1	1	1	0	3
OG0013270	1	1	1	0	3
OG0013271	1	1	1	0	3
OG0013272	1	1	1	0	3
OG0013273	1	1	0	1	3
OG0013274	1	1	1	0	3
OG0013275	1	1	0	1	3
OG0013276	1	0	1	1	3
OG0013277	1	1	1	0	3
OG0013278	1	1	1	0	3
OG0013279	1	1	1	0	3
OG0013280	1	1	1	0	3
OG0013281	1	2	0	0	3
OG0013282	1	1	1	0	3
OG0013283	1	2	0	0	3
OG0013284	1	1	1	0	3
OG0013285	1	1	1	0	3
OG0013286	1	1	1	0	3
OG0013287	1	1	1	0	3
OG0013288	1	1	1	0	3
OG0013289	1	1	1	0	3
OG0013290	1	1	1	0	3
OG0013291	1	1	1	0	3
OG0013292	1	1	1	0	3
OG0013293	1	1	1	0	3
OG0013294	1	2	0	0	3
OG0013295	1	1	1	0	3
OG0013296	1	1	1	0	3
OG0013297	1	2	0	0	3
OG0013298	1	1	1	0	3
OG0013299	1	1	1	0	3
OG0013300	1	1	1	0	3
OG0013301	1	0	1	1	3
OG0013302	2	1	0	0	3
OG0013303	2	0	1	0	3
OG0013304	1	1	1	0	3
OG0013305	1	1	1	0	3
OG0013306	1	1	1	0	3
OG0013307	1	1	1	0	3
OG0013308	1	2	0	0	3
OG0013309	1	1	1	0	3
OG0013310	2	1	0	0	3
OG0013311	1	1	1	0	3
OG0013312	1	1	1	0	3
OG0013313	1	1	1	0	3
OG0013314	1	1	1	0	3
OG0013315	1	1	1	0	3
OG0013316	1	1	1	0	3
OG0013317	1	1	1	0	3
OG0013318	1	1	1	0	3
OG0013319	1	1	1	0	3
OG0013320	1	1	1	0	3
OG0013321	1	1	1	0	3
OG0013322	3	0	0	0	3
OG0013323	1	1	1	0	3
OG0013324	1	1	1	0	3
OG0013325	1	1	1	0	3
OG0013326	1	0	2	0	3
OG0013327	1	1	1	0	3
OG0013328	2	0	1	0	3
OG0013329	1	1	1	0	3
OG0013330	1	1	1	0	3
OG0013331	1	0	1	1	3
OG0013332	1	1	1	0	3
OG0013333	1	1	1	0	3
OG0013334	1	1	1	0	3
OG0013335	1	1	1	0	3
OG0013336	1	1	1	0	3
OG0013337	1	1	1	0	3
OG0013338	1	1	1	0	3
OG0013339	1	1	1	0	3
OG0013340	1	1	1	0	3
OG0013341	1	1	0	1	3
OG0013342	1	1	1	0	3
OG0013343	1	0	0	2	3
OG0013344	1	1	1	0	3
OG0013345	1	1	1	0	3
OG0013346	1	1	1	0	3
OG0013347	1	1	1	0	3
OG0013348	1	1	1	0	3
OG0013349	1	0	1	1	3
OG0013350	3	0	0	0	3
OG0013351	1	1	1	0	3
OG0013352	1	1	1	0	3
OG0013353	1	1	1	0	3
OG0013354	2	1	0	0	3
OG0013355	1	1	1	0	3
OG0013356	1	1	1	0	3
OG0013357	1	1	1	0	3
OG0013358	1	1	1	0	3
OG0013359	1	1	1	0	3
OG0013360	1	1	1	0	3
OG0013361	1	1	1	0	3
OG0013362	1	0	1	1	3
OG0013363	1	1	1	0	3
OG0013364	1	1	0	1	3
OG0013365	1	1	1	0	3
OG0013366	1	1	1	0	3
OG0013367	1	1	1	0	3
OG0013368	1	1	1	0	3
OG0013369	1	1	0	1	3
OG0013370	1	1	1	0	3
OG0013371	1	1	1	0	3
OG0013372	1	1	1	0	3
OG0013373	1	1	0	1	3
OG0013374	1	1	1	0	3
OG0013375	1	2	0	0	3
OG0013376	1	1	1	0	3
OG0013377	1	2	0	0	3
OG0013378	1	1	1	0	3
OG0013379	1	1	1	0	3
OG0013380	1	1	1	0	3
OG0013381	1	1	1	0	3
OG0013382	1	1	1	0	3
OG0013383	1	1	1	0	3
OG0013384	1	1	1	0	3
OG0013385	1	1	1	0	3
OG0013386	1	1	1	0	3
OG0013387	3	0	0	0	3
OG0013388	1	1	1	0	3
OG0013389	1	1	1	0	3
OG0013390	1	1	1	0	3
OG0013391	2	1	0	0	3
OG0013392	1	1	1	0	3
OG0013393	1	1	1	0	3
OG0013394	1	2	0	0	3
OG0013395	1	1	1	0	3
OG0013396	1	1	1	0	3
OG0013397	2	1	0	0	3
OG0013398	1	1	1	0	3
OG0013399	1	1	1	0	3
OG0013400	1	1	1	0	3
OG0013401	1	1	1	0	3
OG0013402	1	1	1	0	3
OG0013403	1	0	1	1	3
OG0013404	1	1	0	1	3
OG0013405	1	1	1	0	3
OG0013406	1	1	0	1	3
OG0013407	1	1	1	0	3
OG0013408	1	1	1	0	3
OG0013409	1	1	1	0	3
OG0013410	1	1	1	0	3
OG0013411	1	1	1	0	3
OG0013412	1	1	1	0	3
OG0013413	1	1	1	0	3
OG0013414	1	1	1	0	3
OG0013415	1	1	1	0	3
OG0013416	2	0	1	0	3
OG0013417	1	1	1	0	3
OG0013418	1	1	1	0	3
OG0013419	1	1	1	0	3
OG0013420	1	1	1	0	3
OG0013421	1	1	0	1	3
OG0013422	1	1	1	0	3
OG0013423	1	0	2	0	3
OG0013424	1	1	1	0	3
OG0013425	1	0	1	1	3
OG0013426	1	1	1	0	3
OG0013427	1	2	0	0	3
OG0013428	1	1	1	0	3
OG0013429	1	1	1	0	3
OG0013430	1	1	1	0	3
OG0013431	1	1	1	0	3
OG0013432	1	1	1	0	3
OG0013433	1	1	1	0	3
OG0013434	1	1	1	0	3
OG0013435	1	1	1	0	3
OG0013436	1	1	1	0	3
OG0013437	1	1	1	0	3
OG0013438	1	1	1	0	3
OG0013439	1	1	1	0	3
OG0013440	1	1	0	1	3
OG0013441	1	1	1	0	3
OG0013442	1	1	1	0	3
OG0013443	1	1	1	0	3
OG0013444	1	1	1	0	3
OG0013445	1	1	1	0	3
OG0013446	1	1	1	0	3
OG0013447	1	1	1	0	3
OG0013448	1	1	1	0	3
OG0013449	1	1	1	0	3
OG0013450	2	1	0	0	3
OG0013451	1	1	1	0	3
OG0013452	1	1	1	0	3
OG0013453	1	1	1	0	3
OG0013454	1	1	1	0	3
OG0013455	1	1	1	0	3
OG0013456	2	0	1	0	3
OG0013457	1	1	1	0	3
OG0013458	1	1	0	1	3
OG0013459	1	1	1	0	3
OG0013460	1	1	1	0	3
OG0013461	1	1	1	0	3
OG0013462	1	1	1	0	3
OG0013463	1	1	1	0	3
OG0013464	1	1	1	0	3
OG0013465	1	1	1	0	3
OG0013466	1	1	1	0	3
OG0013467	1	1	1	0	3
OG0013468	1	1	1	0	3
OG0013469	1	0	2	0	3
OG0013470	1	1	1	0	3
OG0013471	1	1	1	0	3
OG0013472	1	1	1	0	3
OG0013473	1	1	1	0	3
OG0013474	1	1	1	0	3
OG0013475	1	1	1	0	3
OG0013476	1	1	1	0	3
OG0013477	1	1	1	0	3
OG0013478	1	1	1	0	3
OG0013479	1	1	1	0	3
OG0013480	1	1	1	0	3
OG0013481	1	2	0	0	3
OG0013482	1	1	1	0	3
OG0013483	1	1	1	0	3
OG0013484	1	1	1	0	3
OG0013485	1	1	1	0	3
OG0013486	1	1	1	0	3
OG0013487	1	1	1	0	3
OG0013488	1	1	1	0	3
OG0013489	1	1	1	0	3
OG0013490	3	0	0	0	3
OG0013491	1	1	1	0	3
OG0013492	1	1	1	0	3
OG0013493	1	2	0	0	3
OG0013494	1	1	1	0	3
OG0013495	1	1	1	0	3
OG0013496	2	0	1	0	3
OG0013497	1	0	2	0	3
OG0013498	1	1	0	1	3
OG0013499	1	0	2	0	3
OG0013500	1	1	1	0	3
OG0013501	1	1	1	0	3
OG0013502	1	0	2	0	3
OG0013503	1	1	1	0	3
OG0013504	1	1	1	0	3
OG0013505	1	1	1	0	3
OG0013506	1	1	1	0	3
OG0013507	1	1	1	0	3
OG0013508	1	1	1	0	3
OG0013509	1	1	1	0	3
OG0013510	1	1	1	0	3
OG0013511	1	1	1	0	3
OG0013512	1	1	1	0	3
OG0013513	1	1	1	0	3
OG0013514	2	1	0	0	3
OG0013515	1	1	1	0	3
OG0013516	1	0	2	0	3
OG0013517	3	0	0	0	3
OG0013518	1	1	1	0	3
OG0013519	1	1	1	0	3
OG0013520	1	1	1	0	3
OG0013521	1	1	1	0	3
OG0013522	1	1	1	0	3
OG0013523	2	1	0	0	3
OG0013524	1	1	1	0	3
OG0013525	1	1	1	0	3
OG0013526	1	1	1	0	3
OG0013527	1	1	1	0	3
OG0013528	1	1	1	0	3
OG0013529	1	0	1	1	3
OG0013530	1	1	1	0	3
OG0013531	3	0	0	0	3
OG0013532	1	1	0	1	3
OG0013533	1	1	1	0	3
OG0013534	1	1	1	0	3
OG0013535	1	1	1	0	3
OG0013536	1	1	1	0	3
OG0013537	1	1	1	0	3
OG0013538	1	1	1	0	3
OG0013539	2	0	0	1	3
OG0013540	2	1	0	0	3
OG0013541	1	1	1	0	3
OG0013542	1	1	1	0	3
OG0013543	1	1	1	0	3
OG0013544	2	0	1	0	3
OG0013545	2	0	1	0	3
OG0013546	1	1	1	0	3
OG0013547	2	1	0	0	3
OG0013548	1	1	1	0	3
OG0013549	1	1	1	0	3
OG0013550	1	1	1	0	3
OG0013551	1	2	0	0	3
OG0013552	1	1	1	0	3
OG0013553	1	0	1	1	3
OG0013554	1	1	1	0	3
OG0013555	3	0	0	0	3
OG0013556	1	1	1	0	3
OG0013557	1	0	0	2	3
OG0013558	1	1	1	0	3
OG0013559	1	0	2	0	3
OG0013560	1	1	1	0	3
OG0013561	1	1	1	0	3
OG0013562	2	1	0	0	3
OG0013563	2	1	0	0	3
OG0013564	1	1	1	0	3
OG0013565	1	1	1	0	3
OG0013566	1	1	1	0	3
OG0013567	1	1	1	0	3
OG0013568	1	1	1	0	3
OG0013569	1	1	1	0	3
OG0013570	1	2	0	0	3
OG0013571	1	2	0	0	3
OG0013572	1	1	1	0	3
OG0013573	1	1	1	0	3
OG0013574	2	1	0	0	3
OG0013575	1	1	1	0	3
OG0013576	1	1	1	0	3
OG0013577	1	0	1	1	3
OG0013578	1	1	1	0	3
OG0013579	1	1	1	0	3
OG0013580	3	0	0	0	3
OG0013581	1	1	1	0	3
OG0013582	1	1	1	0	3
OG0013583	1	0	1	1	3
OG0013584	1	1	1	0	3
OG0013585	1	1	1	0	3
OG0013586	1	1	1	0	3
OG0013587	1	1	0	1	3
OG0013588	1	1	1	0	3
OG0013589	1	1	1	0	3
OG0013590	1	1	1	0	3
OG0013591	1	1	1	0	3
OG0013592	2	1	0	0	3
OG0013593	1	0	1	1	3
OG0013594	1	2	0	0	3
OG0013595	1	1	1	0	3
OG0013596	1	1	0	1	3
OG0013597	1	1	0	1	3
OG0013598	1	0	2	0	3
OG0013599	1	1	1	0	3
OG0013600	1	1	1	0	3
OG0013601	1	1	0	1	3
OG0013602	2	1	0	0	3
OG0013603	1	1	1	0	3
OG0013604	1	1	1	0	3
OG0013605	1	1	1	0	3
OG0013606	1	1	1	0	3
OG0013607	1	0	1	1	3
OG0013608	1	1	1	0	3
OG0013609	1	1	1	0	3
OG0013610	1	1	1	0	3
OG0013611	1	1	1	0	3
OG0013612	1	1	1	0	3
OG0013613	1	1	1	0	3
OG0013614	1	1	1	0	3
OG0013615	1	0	2	0	3
OG0013616	1	1	1	0	3
OG0013617	1	1	1	0	3
OG0013618	1	2	0	0	3
OG0013619	1	0	1	1	3
OG0013620	1	1	1	0	3
OG0013621	1	1	1	0	3
OG0013622	1	1	1	0	3
OG0013623	1	1	1	0	3
OG0013624	1	1	1	0	3
OG0013625	1	1	1	0	3
OG0013626	1	1	1	0	3
OG0013627	1	1	1	0	3
OG0013628	1	0	2	0	3
OG0013629	1	1	0	1	3
OG0013630	1	1	1	0	3
OG0013631	1	1	1	0	3
OG0013632	1	1	1	0	3
OG0013633	1	1	1	0	3
OG0013634	1	1	0	1	3
OG0013635	1	1	1	0	3
OG0013636	1	1	1	0	3
OG0013637	1	2	0	0	3
OG0013638	1	1	1	0	3
OG0013639	1	1	1	0	3
OG0013640	1	0	1	1	3
OG0013641	1	1	1	0	3
OG0013642	1	0	2	0	3
OG0013643	1	0	1	1	3
OG0013644	1	1	0	1	3
OG0013645	1	1	1	0	3
OG0013646	1	1	1	0	3
OG0013647	1	1	1	0	3
OG0013648	1	1	1	0	3
OG0013649	1	0	2	0	3
OG0013650	1	1	1	0	3
OG0013651	1	1	1	0	3
OG0013652	1	1	1	0	3
OG0013653	2	1	0	0	3
OG0013654	1	1	0	1	3
OG0013655	1	1	1	0	3
OG0013656	1	1	1	0	3
OG0013657	1	1	1	0	3
OG0013658	1	1	1	0	3
OG0013659	1	1	1	0	3
OG0013660	1	1	1	0	3
OG0013661	1	0	2	0	3
OG0013662	1	1	1	0	3
OG0013663	1	1	1	0	3
OG0013664	1	1	1	0	3
OG0013665	1	1	1	0	3
OG0013666	1	1	1	0	3
OG0013667	1	1	1	0	3
OG0013668	1	1	0	1	3
OG0013669	1	1	1	0	3
OG0013670	1	1	1	0	3
OG0013671	1	1	1	0	3
OG0013672	1	1	1	0	3
OG0013673	1	1	0	1	3
OG0013674	1	1	1	0	3
OG0013675	1	1	1	0	3
OG0013676	1	1	1	0	3
OG0013677	1	1	1	0	3
OG0013678	1	1	1	0	3
OG0013679	1	1	1	0	3
OG0013680	1	1	1	0	3
OG0013681	1	1	1	0	3
OG0013682	1	1	1	0	3
OG0013683	1	1	1	0	3
OG0013684	1	1	1	0	3
OG0013685	1	1	1	0	3
OG0013686	1	1	1	0	3
OG0013687	0	3	0	0	3
OG0013688	0	3	0	0	3
OG0013689	0	1	1	1	3
OG0013690	0	1	1	1	3
OG0013691	0	1	1	1	3
OG0013692	0	3	0	0	3
OG0013693	0	3	0	0	3
OG0013694	0	1	1	1	3
OG0013695	0	1	1	1	3
OG0013696	0	1	1	1	3
OG0013697	0	3	0	0	3
OG0013698	0	1	2	0	3
OG0013699	0	1	1	1	3
OG0013700	0	1	1	1	3
OG0013701	0	1	1	1	3
OG0013702	0	1	2	0	3
OG0013703	0	1	2	0	3
OG0013704	0	1	1	1	3
OG0013705	0	3	0	0	3
OG0013706	0	3	0	0	3
OG0013707	0	1	1	1	3
OG0013708	0	3	0	0	3
OG0013709	0	2	1	0	3
OG0013710	0	3	0	0	3
OG0013711	0	1	1	1	3
OG0013712	0	1	1	1	3
OG0013713	0	1	1	1	3
OG0013714	0	1	1	1	3
OG0013715	0	3	0	0	3
OG0013716	0	1	1	1	3
OG0013717	0	1	1	1	3
OG0013718	0	1	1	1	3
OG0013719	0	3	0	0	3
OG0013720	0	1	1	1	3
OG0013721	0	1	1	1	3
OG0013722	0	1	1	1	3
OG0013723	0	1	1	1	3
OG0013724	0	3	0	0	3
OG0013725	0	1	1	1	3
OG0013726	0	1	1	1	3
OG0013727	0	1	1	1	3
OG0013728	0	1	1	1	3
OG0013729	0	3	0	0	3
OG0013730	0	1	1	1	3
OG0013731	0	3	0	0	3
OG0013732	0	3	0	0	3
OG0013733	0	1	1	1	3
OG0013734	0	3	0	0	3
OG0013735	0	3	0	0	3
OG0013736	0	1	1	1	3
OG0013737	0	1	1	1	3
OG0013738	0	1	1	1	3
OG0013739	0	1	2	0	3
OG0013740	0	3	0	0	3
OG0013741	0	1	1	1	3
OG0013742	0	1	1	1	3
OG0013743	0	3	0	0	3
OG0013744	0	3	0	0	3
OG0013745	0	1	1	1	3
OG0013746	0	1	1	1	3
OG0013747	0	1	1	1	3
OG0013748	0	1	1	1	3
OG0013749	0	1	1	1	3
OG0013750	0	1	1	1	3
OG0013751	0	3	0	0	3
OG0013752	0	3	0	0	3
OG0013753	0	1	1	1	3
OG0013754	0	1	1	1	3
OG0013755	0	1	1	1	3
OG0013756	0	3	0	0	3
OG0013757	0	1	2	0	3
OG0013758	0	1	1	1	3
OG0013759	0	1	1	1	3
OG0013760	0	1	1	1	3
OG0013761	0	1	2	0	3
OG0013762	0	1	1	1	3
OG0013763	0	1	1	1	3
OG0013764	0	1	1	1	3
OG0013765	0	1	1	1	3
OG0013766	0	3	0	0	3
OG0013767	0	3	0	0	3
OG0013768	0	1	1	1	3
OG0013769	0	2	1	0	3
OG0013770	0	3	0	0	3
OG0013771	0	1	1	1	3
OG0013772	0	1	2	0	3
OG0013773	0	1	1	1	3
OG0013774	0	1	1	1	3
OG0013775	0	2	1	0	3
OG0013776	0	1	1	1	3
OG0013777	0	1	1	1	3
OG0013778	0	1	1	1	3
OG0013779	0	1	1	1	3
OG0013780	0	1	1	1	3
OG0013781	0	1	1	1	3
OG0013782	0	1	1	1	3
OG0013783	0	1	1	1	3
OG0013784	0	3	0	0	3
OG0013785	0	1	1	1	3
OG0013786	0	1	1	1	3
OG0013787	0	3	0	0	3
OG0013788	0	3	0	0	3
OG0013789	0	3	0	0	3
OG0013790	0	3	0	0	3
OG0013791	0	1	1	1	3
OG0013792	0	1	1	1	3
OG0013793	0	1	1	1	3
OG0013794	0	1	1	1	3
OG0013795	0	3	0	0	3
OG0013796	0	1	1	1	3
OG0013797	0	1	1	1	3
OG0013798	0	1	1	1	3
OG0013799	0	3	0	0	3
OG0013800	0	1	1	1	3
OG0013801	0	3	0	0	3
OG0013802	0	3	0	0	3
OG0013803	0	1	1	1	3
OG0013804	0	2	1	0	3
OG0013805	0	3	0	0	3
OG0013806	0	1	1	1	3
OG0013807	0	3	0	0	3
OG0013808	0	3	0	0	3
OG0013809	0	1	1	1	3
OG0013810	0	1	0	2	3
OG0013811	0	1	2	0	3
OG0013812	0	3	0	0	3
OG0013813	0	3	0	0	3
OG0013814	0	3	0	0	3
OG0013815	0	3	0	0	3
OG0013816	0	3	0	0	3
OG0013817	0	1	1	1	3
OG0013818	0	3	0	0	3
OG0013819	0	2	1	0	3
OG0013820	0	3	0	0	3
OG0013821	0	2	0	1	3
OG0013822	0	3	0	0	3
OG0013823	0	1	1	1	3
OG0013824	0	3	0	0	3
OG0013825	0	1	1	1	3
OG0013826	0	1	2	0	3
OG0013827	0	3	0	0	3
OG0013828	0	1	1	1	3
OG0013829	0	1	2	0	3
OG0013830	0	3	0	0	3
OG0013831	0	1	1	1	3
OG0013832	0	1	2	0	3
OG0013833	0	3	0	0	3
OG0013834	0	2	1	0	3
OG0013835	0	3	0	0	3
OG0013836	0	3	0	0	3
OG0013837	0	1	1	1	3
OG0013838	0	1	1	1	3
OG0013839	0	3	0	0	3
OG0013840	0	3	0	0	3
OG0013841	0	3	0	0	3
OG0013842	0	3	0	0	3
OG0013843	0	1	2	0	3
OG0013844	0	1	2	0	3
OG0013845	0	2	1	0	3
OG0013846	0	2	0	1	3
OG0013847	0	1	1	1	3
OG0013848	0	1	1	1	3
OG0013849	0	3	0	0	3
OG0013850	0	3	0	0	3
OG0013851	0	1	1	1	3
OG0013852	0	3	0	0	3
OG0013853	0	1	2	0	3
OG0013854	0	1	1	1	3
OG0013855	0	1	1	1	3
OG0013856	0	3	0	0	3
OG0013857	0	2	1	0	3
OG0013858	0	1	1	1	3
OG0013859	0	2	1	0	3
OG0013860	0	3	0	0	3
OG0013861	0	1	1	1	3
OG0013862	0	3	0	0	3
OG0013863	0	3	0	0	3
OG0013864	0	3	0	0	3
OG0013865	0	2	1	0	3
OG0013866	0	3	0	0	3
OG0013867	0	1	1	1	3
OG0013868	0	1	1	1	3
OG0013869	0	1	1	1	3
OG0013870	0	1	1	1	3
OG0013871	0	1	1	1	3
OG0013872	0	1	1	1	3
OG0013873	0	1	1	1	3
OG0013874	0	1	2	0	3
OG0013875	0	1	1	1	3
OG0013876	0	1	2	0	3
OG0013877	0	3	0	0	3
OG0013878	0	1	1	1	3
OG0013879	0	3	0	0	3
OG0013880	0	1	2	0	3
OG0013881	0	1	2	0	3
OG0013882	0	1	1	1	3
OG0013883	0	3	0	0	3
OG0013884	0	1	1	1	3
OG0013885	0	1	1	1	3
OG0013886	0	3	0	0	3
OG0013887	0	1	1	1	3
OG0013888	0	3	0	0	3
OG0013889	0	1	1	1	3
OG0013890	0	1	1	1	3
OG0013891	0	1	1	1	3
OG0013892	0	1	2	0	3
OG0013893	0	1	1	1	3
OG0013894	0	3	0	0	3
OG0013895	0	1	1	1	3
OG0013896	0	2	1	0	3
OG0013897	0	3	0	0	3
OG0013898	0	3	0	0	3
OG0013899	0	1	1	1	3
OG0013900	0	1	2	0	3
OG0013901	0	3	0	0	3
OG0013902	0	3	0	0	3
OG0013903	0	2	1	0	3
OG0013904	0	3	0	0	3
OG0013905	0	1	1	1	3
OG0013906	0	3	0	0	3
OG0013907	0	3	0	0	3
OG0013908	0	1	2	0	3
OG0013909	0	1	1	1	3
OG0013910	0	2	1	0	3
OG0013911	0	3	0	0	3
OG0013912	0	3	0	0	3
OG0013913	0	1	2	0	3
OG0013914	0	1	2	0	3
OG0013915	0	1	1	1	3
OG0013916	0	2	1	0	3
OG0013917	0	2	0	1	3
OG0013918	0	1	1	1	3
OG0013919	0	1	1	1	3
OG0013920	0	3	0	0	3
OG0013921	0	1	1	1	3
OG0013922	0	3	0	0	3
OG0013923	0	2	1	0	3
OG0013924	0	3	0	0	3
OG0013925	0	3	0	0	3
OG0013926	0	1	1	1	3
OG0013927	0	1	1	1	3
OG0013928	0	3	0	0	3
OG0013929	0	1	1	1	3
OG0013930	0	3	0	0	3
OG0013931	0	3	0	0	3
OG0013932	0	1	1	1	3
OG0013933	0	1	2	0	3
OG0013934	0	3	0	0	3
OG0013935	0	1	1	1	3
OG0013936	0	3	0	0	3
OG0013937	0	1	2	0	3
OG0013938	0	3	0	0	3
OG0013939	0	1	1	1	3
OG0013940	0	1	1	1	3
OG0013941	0	1	2	0	3
OG0013942	0	1	1	1	3
OG0013943	0	2	1	0	3
OG0013944	0	1	2	0	3
OG0013945	0	1	1	1	3
OG0013946	0	3	0	0	3
OG0013947	0	3	0	0	3
OG0013948	0	1	1	1	3
OG0013949	0	1	1	1	3
OG0013950	0	3	0	0	3
OG0013951	0	1	2	0	3
OG0013952	0	3	0	0	3
OG0013953	0	1	1	1	3
OG0013954	0	1	1	1	3
OG0013955	0	1	1	1	3
OG0013956	0	3	0	0	3
OG0013957	0	3	0	0	3
OG0013958	0	1	0	2	3
OG0013959	0	3	0	0	3
OG0013960	0	1	1	1	3
OG0013961	0	1	1	1	3
OG0013962	0	1	1	1	3
OG0013963	0	3	0	0	3
OG0013964	0	2	1	0	3
OG0013965	0	1	1	1	3
OG0013966	0	1	1	1	3
OG0013967	0	1	2	0	3
OG0013968	0	1	1	1	3
OG0013969	0	3	0	0	3
OG0013970	0	1	1	1	3
OG0013971	0	1	1	1	3
OG0013972	0	1	2	0	3
OG0013973	0	1	1	1	3
OG0013974	0	1	1	1	3
OG0013975	0	1	1	1	3
OG0013976	0	0	3	0	3
OG0013977	0	0	3	0	3
OG0013978	0	0	2	1	3
OG0013979	0	0	3	0	3
OG0013980	0	0	3	0	3
OG0013981	0	0	3	0	3
OG0013982	0	0	3	0	3
OG0013983	0	0	3	0	3
OG0013984	0	0	3	0	3
OG0013985	0	0	3	0	3
OG0013986	0	0	3	0	3
OG0013987	0	0	3	0	3
OG0013988	0	0	3	0	3
OG0013989	0	0	3	0	3
OG0013990	0	0	3	0	3
OG0013991	0	0	3	0	3
OG0013992	0	0	3	0	3
OG0013993	0	0	3	0	3
OG0013994	0	0	3	0	3
OG0013995	0	0	3	0	3
OG0013996	0	0	3	0	3
OG0013997	0	0	3	0	3
OG0013998	0	0	3	0	3
OG0013999	0	0	3	0	3
OG0014000	0	0	3	0	3
OG0014001	0	0	3	0	3
OG0014002	0	0	1	2	3
OG0014003	0	0	3	0	3
OG0014004	0	0	3	0	3
OG0014005	0	0	3	0	3
OG0014006	0	0	3	0	3
OG0014007	0	0	1	2	3
OG0014008	0	0	3	0	3
OG0014009	0	0	3	0	3
OG0014010	0	0	3	0	3
OG0014011	0	0	3	0	3
OG0014012	0	0	3	0	3
OG0014013	0	0	3	0	3
OG0014014	0	0	3	0	3
OG0014015	0	0	3	0	3
OG0014016	0	0	3	0	3
OG0014017	0	0	3	0	3
OG0014018	0	0	3	0	3
OG0014019	0	0	3	0	3
OG0014020	0	0	3	0	3
OG0014021	0	0	3	0	3
OG0014022	0	0	3	0	3
OG0014023	0	0	3	0	3
OG0014024	0	0	3	0	3
OG0014025	0	0	3	0	3
OG0014026	0	0	3	0	3
OG0014027	0	0	3	0	3
OG0014028	0	0	3	0	3
OG0014029	0	0	3	0	3
OG0014030	0	0	3	0	3
OG0014031	0	0	3	0	3
OG0014032	0	0	3	0	3
OG0014033	0	0	3	0	3
OG0014034	0	0	2	1	3
OG0014035	0	0	3	0	3
OG0014036	0	0	3	0	3
OG0014037	0	0	3	0	3
OG0014038	0	0	2	1	3
OG0014039	0	0	2	1	3
OG0014040	0	0	3	0	3
OG0014041	0	0	3	0	3
OG0014042	0	0	3	0	3
OG0014043	0	0	3	0	3
OG0014044	0	0	3	0	3
OG0014045	0	0	3	0	3
OG0014046	0	0	3	0	3
OG0014047	0	0	2	1	3
OG0014048	0	0	3	0	3
OG0014049	0	0	3	0	3
OG0014050	0	0	3	0	3
OG0014051	0	0	3	0	3
OG0014052	0	0	3	0	3
OG0014053	0	0	3	0	3
OG0014054	0	0	3	0	3
OG0014055	0	0	3	0	3
OG0014056	0	0	3	0	3
OG0014057	0	0	3	0	3
OG0014058	0	0	3	0	3
OG0014059	0	0	3	0	3
OG0014060	0	0	3	0	3
OG0014061	0	0	3	0	3
OG0014062	0	0	3	0	3
OG0014063	0	0	2	1	3
OG0014064	0	0	3	0	3
OG0014065	0	0	3	0	3
OG0014066	0	0	3	0	3
OG0014067	0	0	3	0	3
OG0014068	0	0	3	0	3
OG0014069	0	0	3	0	3
OG0014070	0	0	3	0	3
OG0014071	0	0	3	0	3
OG0014072	0	0	3	0	3
OG0014073	0	0	3	0	3
OG0014074	0	0	3	0	3
OG0014075	0	0	3	0	3
OG0014076	0	0	2	1	3
OG0014077	0	0	3	0	3
OG0014078	0	0	3	0	3
OG0014079	0	0	3	0	3
OG0014080	0	0	3	0	3
OG0014081	0	0	2	1	3
OG0014082	0	0	3	0	3
OG0014083	0	0	3	0	3
OG0014084	0	0	3	0	3
OG0014085	0	0	3	0	3
OG0014086	0	0	3	0	3
OG0014087	0	0	3	0	3
OG0014088	0	0	3	0	3
OG0014089	0	0	3	0	3
OG0014090	0	0	3	0	3
OG0014091	0	0	3	0	3
OG0014092	0	0	3	0	3
OG0014093	0	0	3	0	3
OG0014094	0	0	3	0	3
OG0014095	0	0	3	0	3
OG0014096	0	0	1	2	3
OG0014097	0	0	3	0	3
OG0014098	0	0	3	0	3
OG0014099	0	0	3	0	3
OG0014100	0	0	3	0	3
OG0014101	0	0	3	0	3
OG0014102	0	0	1	2	3
OG0014103	0	0	3	0	3
OG0014104	0	0	3	0	3
OG0014105	0	0	3	0	3
OG0014106	0	0	3	0	3
OG0014107	0	0	3	0	3
OG0014108	0	0	3	0	3
OG0014109	0	0	3	0	3
OG0014110	0	0	3	0	3
OG0014111	0	0	3	0	3
OG0014112	0	0	3	0	3
OG0014113	0	0	3	0	3
OG0014114	0	0	1	2	3
OG0014115	0	0	1	2	3
OG0014116	0	0	3	0	3
OG0014117	0	0	3	0	3
OG0014118	0	0	3	0	3
OG0014119	0	0	2	1	3
OG0014120	0	0	3	0	3
OG0014121	0	0	3	0	3
OG0014122	0	0	3	0	3
OG0014123	0	0	3	0	3
OG0014124	0	0	3	0	3
OG0014125	0	0	3	0	3
OG0014126	0	0	3	0	3
OG0014127	0	0	3	0	3
OG0014128	0	0	3	0	3
OG0014129	0	0	3	0	3
OG0014130	0	0	3	0	3
OG0014131	0	0	1	2	3
OG0014132	0	0	3	0	3
OG0014133	0	0	1	2	3
OG0014134	0	0	3	0	3
OG0014135	0	0	3	0	3
OG0014136	0	0	1	2	3
OG0014137	0	0	3	0	3
OG0014138	0	0	1	2	3
OG0014139	0	0	3	0	3
OG0014140	0	0	3	0	3
OG0014141	0	0	1	2	3
OG0014142	0	0	3	0	3
OG0014143	0	0	2	1	3
OG0014144	0	0	2	1	3
OG0014145	0	0	3	0	3
OG0014146	0	0	2	1	3
OG0014147	0	0	3	0	3
OG0014148	0	0	2	1	3
OG0014149	0	0	3	0	3
OG0014150	0	0	3	0	3
OG0014151	0	0	3	0	3
OG0014152	0	0	3	0	3
OG0014153	0	0	3	0	3
OG0014154	0	0	3	0	3
OG0014155	0	0	3	0	3
OG0014156	0	0	3	0	3
OG0014157	0	0	3	0	3
OG0014158	0	0	3	0	3
OG0014159	0	0	3	0	3
OG0014160	0	0	3	0	3
OG0014161	0	0	2	1	3
OG0014162	0	0	3	0	3
OG0014163	0	0	2	1	3
OG0014164	0	0	3	0	3
OG0014165	0	0	1	2	3
OG0014166	0	0	1	2	3
OG0014167	0	0	2	1	3
OG0014168	0	0	1	2	3
OG0014169	0	0	1	2	3
OG0014170	0	0	0	3	3
OG0014171	0	0	0	3	3
OG0014172	0	0	0	3	3
OG0014173	0	0	0	3	3
OG0014174	0	0	0	3	3
OG0014175	0	0	0	3	3
OG0014176	0	0	0	3	3
OG0014177	0	0	0	3	3
OG0014178	0	0	0	3	3
OG0014179	0	0	0	3	3
OG0014180	0	0	0	3	3
OG0014181	0	0	0	3	3
OG0014182	0	0	0	3	3
OG0014183	0	0	0	3	3
OG0014184	0	0	0	3	3
OG0014185	0	0	0	3	3
OG0014186	0	0	0	3	3
OG0014187	0	0	0	3	3
OG0014188	0	0	0	3	3
OG0014189	0	0	0	3	3
OG0014190	0	0	0	3	3
OG0014191	0	0	0	3	3
OG0014192	0	0	0	3	3
OG0014193	0	0	0	3	3
OG0014194	0	0	0	3	3
OG0014195	0	0	0	3	3
OG0014196	0	0	0	3	3
OG0014197	0	0	0	3	3
OG0014198	0	0	0	3	3
OG0014199	0	0	0	3	3
OG0014200	0	0	0	3	3
OG0014201	0	0	0	3	3
OG0014202	0	0	0	3	3
OG0014203	0	0	0	3	3
OG0014204	0	0	0	3	3
OG0014205	0	0	0	3	3
OG0014206	0	0	0	3	3
OG0014207	0	0	0	3	3
OG0014208	0	0	0	3	3
OG0014209	0	0	0	3	3
OG0014210	0	0	0	3	3
OG0014211	0	0	0	3	3
OG0014212	0	0	0	3	3
OG0014213	0	0	0	3	3
OG0014214	0	0	0	3	3
OG0014215	0	0	0	3	3
OG0014216	0	0	0	3	3
OG0014217	0	0	0	3	3
OG0014218	0	0	0	3	3
OG0014219	0	0	0	3	3
OG0014220	0	0	0	3	3
OG0014221	0	0	0	3	3
OG0014222	0	0	0	3	3
OG0014223	0	0	0	3	3
OG0014224	0	0	0	3	3
OG0014225	0	0	0	3	3
OG0014226	0	0	0	3	3
OG0014227	0	0	0	3	3
OG0014228	0	0	0	3	3
OG0014229	0	0	0	3	3
OG0014230	0	0	0	3	3
OG0014231	0	0	0	3	3
OG0014232	0	0	0	3	3
OG0014233	0	0	0	3	3
OG0014234	0	0	0	3	3
OG0014235	0	0	0	3	3
OG0014236	0	0	0	3	3
OG0014237	0	0	0	3	3
OG0014238	0	0	0	3	3
OG0014239	0	0	0	3	3
OG0014240	0	0	0	3	3
OG0014241	0	0	0	3	3
OG0014242	0	0	0	3	3
OG0014243	0	0	0	3	3
OG0014244	0	0	0	3	3
OG0014245	0	0	0	3	3
OG0014246	0	0	0	3	3
OG0014247	0	0	0	3	3
OG0014248	0	0	0	3	3
OG0014249	0	0	0	3	3
OG0014250	0	0	0	3	3
OG0014251	0	0	0	3	3
OG0014252	0	0	0	3	3
OG0014253	0	0	0	3	3
OG0014254	0	0	0	3	3
OG0014255	0	0	0	3	3
OG0014256	0	0	0	3	3
OG0014257	0	0	0	3	3
OG0014258	0	0	0	3	3
OG0014259	0	0	0	3	3
OG0014260	0	0	0	3	3
OG0014261	0	0	0	3	3
OG0014262	0	0	0	3	3
OG0014263	0	0	0	3	3
OG0014264	0	0	0	3	3
OG0014265	0	0	0	3	3
OG0014266	0	0	0	3	3
OG0014267	0	0	0	3	3
OG0014268	0	0	0	3	3
OG0014269	0	0	0	3	3
OG0014270	0	0	0	3	3
OG0014271	0	0	0	3	3
OG0014272	0	0	0	3	3
OG0014273	0	0	0	3	3
OG0014274	0	0	0	3	3
OG0014275	0	0	0	3	3
OG0014276	0	0	0	3	3
OG0014277	0	0	0	3	3
OG0014278	0	0	0	3	3
OG0014279	0	0	0	3	3
OG0014280	0	0	0	3	3
OG0014281	0	0	0	3	3
OG0014282	0	0	0	3	3
OG0014283	0	0	0	3	3
OG0014284	0	0	0	3	3
OG0014285	0	0	0	3	3
OG0014286	0	0	0	3	3
OG0014287	0	0	0	3	3
OG0014288	0	0	0	3	3
OG0014289	0	0	0	3	3
OG0014290	0	0	0	3	3
OG0014291	0	0	0	3	3
OG0014292	0	0	0	3	3
OG0014293	0	0	0	3	3
OG0014294	0	0	0	3	3
OG0014295	0	0	0	3	3
OG0014296	0	0	0	3	3
OG0014297	0	0	0	3	3
OG0014298	0	0	0	3	3
OG0014299	0	0	0	3	3
OG0014300	0	0	0	3	3
OG0014301	0	0	0	3	3
OG0014302	0	0	0	3	3
OG0014303	0	0	0	3	3
OG0014304	0	0	0	3	3
OG0014305	0	0	0	3	3
OG0014306	0	0	0	3	3
OG0014307	0	0	0	3	3
OG0014308	0	0	0	3	3
OG0014309	0	0	0	3	3
OG0014310	0	0	0	3	3
OG0014311	0	0	0	3	3
OG0014312	0	0	0	3	3
OG0014313	0	0	0	3	3
OG0014314	0	0	0	3	3
OG0014315	0	0	0	3	3
OG0014316	0	0	0	3	3
OG0014317	0	0	0	3	3
OG0014318	0	0	0	3	3
OG0014319	0	0	0	3	3
OG0014320	0	0	0	3	3
OG0014321	0	0	0	3	3
OG0014322	0	0	0	3	3
OG0014323	0	0	0	3	3
OG0014324	0	0	0	3	3
OG0014325	0	0	0	3	3
OG0014326	0	0	0	3	3
OG0014327	0	0	0	3	3
OG0014328	0	0	0	3	3
OG0014329	0	0	0	3	3
OG0014330	0	0	0	3	3
OG0014331	0	0	0	3	3
OG0014332	0	0	0	3	3
OG0014333	0	0	0	3	3
OG0014334	0	0	0	3	3
OG0014335	0	0	0	3	3
OG0014336	0	0	0	3	3
OG0014337	0	0	0	3	3
OG0014338	0	0	0	3	3
OG0014339	0	0	0	3	3
OG0014340	0	0	0	3	3
OG0014341	0	0	0	3	3
OG0014342	0	0	0	3	3
OG0014343	0	0	0	3	3
OG0014344	0	0	0	3	3
OG0014345	0	0	0	3	3
OG0014346	0	0	0	3	3
OG0014347	0	0	0	3	3
OG0014348	0	0	0	3	3
OG0014349	0	0	0	3	3
OG0014350	0	0	0	3	3
OG0014351	0	0	0	3	3
OG0014352	0	0	0	3	3
OG0014353	0	0	0	3	3
OG0014354	0	0	0	3	3
OG0014355	0	0	0	3	3
OG0014356	0	0	0	3	3
OG0014357	0	0	0	3	3
OG0014358	0	0	0	3	3
OG0014359	0	0	0	3	3
OG0014360	0	0	0	3	3
OG0014361	0	0	0	3	3
OG0014362	0	0	0	3	3
OG0014363	0	0	0	3	3
OG0014364	0	0	0	3	3
OG0014365	0	0	0	3	3
OG0014366	0	0	0	3	3
OG0014367	0	0	0	3	3
OG0014368	0	0	0	3	3
OG0014369	0	0	0	3	3
OG0014370	0	0	0	3	3
OG0014371	0	0	0	3	3
OG0014372	0	0	0	3	3
OG0014373	0	0	0	3	3
OG0014374	0	0	0	3	3
OG0014375	0	0	0	3	3
OG0014376	0	0	0	3	3
OG0014377	0	0	0	3	3
OG0014378	0	0	0	3	3
OG0014379	0	0	0	3	3
OG0014380	0	0	0	3	3
OG0014381	0	0	0	3	3
OG0014382	0	0	0	3	3
OG0014383	0	0	0	3	3
OG0014384	0	0	0	3	3
OG0014385	0	0	0	3	3
OG0014386	0	0	0	3	3
OG0014387	0	0	0	3	3
OG0014388	0	0	0	3	3
OG0014389	0	0	0	3	3
OG0014390	0	0	0	3	3
OG0014391	0	0	0	3	3
OG0014392	0	0	0	3	3
OG0014393	0	0	0	3	3
OG0014394	0	0	0	3	3
OG0014395	0	0	0	3	3
OG0014396	0	0	0	3	3
OG0014397	0	0	0	3	3
OG0014398	0	0	0	3	3
OG0014399	0	0	0	3	3
OG0014400	0	0	0	3	3
OG0014401	0	0	0	3	3
OG0014402	0	0	0	3	3
OG0014403	0	0	0	3	3
OG0014404	0	0	0	3	3
OG0014405	0	0	0	3	3
OG0014406	0	0	0	3	3
OG0014407	0	0	0	3	3
OG0014408	0	0	0	3	3
OG0014409	0	0	0	3	3
OG0014410	0	0	0	3	3
OG0014411	0	0	0	3	3
OG0014412	0	0	0	3	3
OG0014413	0	0	0	3	3
OG0014414	0	0	0	3	3
OG0014415	0	0	0	3	3
OG0014416	0	0	0	3	3
OG0014417	0	0	0	3	3
OG0014418	0	0	0	3	3
OG0014419	1	1	0	0	2
OG0014420	2	0	0	0	2
OG0014421	1	1	0	0	2
OG0014422	2	0	0	0	2
OG0014423	1	1	0	0	2
OG0014424	1	1	0	0	2
OG0014425	1	1	0	0	2
OG0014426	1	1	0	0	2
OG0014427	2	0	0	0	2
OG0014428	1	1	0	0	2
OG0014429	1	1	0	0	2
OG0014430	1	0	1	0	2
OG0014431	2	0	0	0	2
OG0014432	2	0	0	0	2
OG0014433	1	1	0	0	2
OG0014434	1	0	1	0	2
OG0014435	2	0	0	0	2
OG0014436	1	1	0	0	2
OG0014437	1	1	0	0	2
OG0014438	1	0	0	1	2
OG0014439	1	1	0	0	2
OG0014440	1	0	1	0	2
OG0014441	1	1	0	0	2
OG0014442	1	1	0	0	2
OG0014443	1	0	1	0	2
OG0014444	2	0	0	0	2
OG0014445	1	1	0	0	2
OG0014446	1	0	1	0	2
OG0014447	1	1	0	0	2
OG0014448	1	1	0	0	2
OG0014449	1	1	0	0	2
OG0014450	1	0	1	0	2
OG0014451	1	0	0	1	2
OG0014452	1	0	1	0	2
OG0014453	1	1	0	0	2
OG0014454	1	0	1	0	2
OG0014455	1	1	0	0	2
OG0014456	1	1	0	0	2
OG0014457	1	1	0	0	2
OG0014458	1	1	0	0	2
OG0014459	1	1	0	0	2
OG0014460	1	1	0	0	2
OG0014461	1	0	1	0	2
OG0014462	1	1	0	0	2
OG0014463	1	1	0	0	2
OG0014464	2	0	0	0	2
OG0014465	1	1	0	0	2
OG0014466	1	0	1	0	2
OG0014467	1	1	0	0	2
OG0014468	2	0	0	0	2
OG0014469	2	0	0	0	2
OG0014470	1	1	0	0	2
OG0014471	1	0	1	0	2
OG0014472	1	1	0	0	2
OG0014473	2	0	0	0	2
OG0014474	1	1	0	0	2
OG0014475	1	1	0	0	2
OG0014476	2	0	0	0	2
OG0014477	1	1	0	0	2
OG0014478	1	0	1	0	2
OG0014479	1	1	0	0	2
OG0014480	2	0	0	0	2
OG0014481	1	0	1	0	2
OG0014482	2	0	0	0	2
OG0014483	1	1	0	0	2
OG0014484	2	0	0	0	2
OG0014485	2	0	0	0	2
OG0014486	1	0	0	1	2
OG0014487	1	1	0	0	2
OG0014488	1	1	0	0	2
OG0014489	1	1	0	0	2
OG0014490	2	0	0	0	2
OG0014491	2	0	0	0	2
OG0014492	1	1	0	0	2
OG0014493	2	0	0	0	2
OG0014494	1	0	1	0	2
OG0014495	1	1	0	0	2
OG0014496	1	1	0	0	2
OG0014497	1	1	0	0	2
OG0014498	1	1	0	0	2
OG0014499	2	0	0	0	2
OG0014500	1	1	0	0	2
OG0014501	1	1	0	0	2
OG0014502	2	0	0	0	2
OG0014503	2	0	0	0	2
OG0014504	2	0	0	0	2
OG0014505	1	1	0	0	2
OG0014506	1	1	0	0	2
OG0014507	1	1	0	0	2
OG0014508	1	1	0	0	2
OG0014509	1	1	0	0	2
OG0014510	2	0	0	0	2
OG0014511	2	0	0	0	2
OG0014512	2	0	0	0	2
OG0014513	1	1	0	0	2
OG0014514	1	1	0	0	2
OG0014515	1	1	0	0	2
OG0014516	1	1	0	0	2
OG0014517	2	0	0	0	2
OG0014518	2	0	0	0	2
OG0014519	1	0	1	0	2
OG0014520	1	1	0	0	2
OG0014521	1	1	0	0	2
OG0014522	2	0	0	0	2
OG0014523	1	1	0	0	2
OG0014524	1	1	0	0	2
OG0014525	2	0	0	0	2
OG0014526	1	1	0	0	2
OG0014527	1	1	0	0	2
OG0014528	1	1	0	0	2
OG0014529	1	0	0	1	2
OG0014530	1	0	1	0	2
OG0014531	1	1	0	0	2
OG0014532	1	1	0	0	2
OG0014533	1	1	0	0	2
OG0014534	1	1	0	0	2
OG0014535	1	0	0	1	2
OG0014536	2	0	0	0	2
OG0014537	1	1	0	0	2
OG0014538	2	0	0	0	2
OG0014539	1	0	0	1	2
OG0014540	2	0	0	0	2
OG0014541	1	0	1	0	2
OG0014542	1	1	0	0	2
OG0014543	1	1	0	0	2
OG0014544	2	0	0	0	2
OG0014545	1	1	0	0	2
OG0014546	1	1	0	0	2
OG0014547	1	1	0	0	2
OG0014548	1	0	1	0	2
OG0014549	2	0	0	0	2
OG0014550	1	1	0	0	2
OG0014551	1	1	0	0	2
OG0014552	1	1	0	0	2
OG0014553	1	1	0	0	2
OG0014554	2	0	0	0	2
OG0014555	1	0	1	0	2
OG0014556	1	1	0	0	2
OG0014557	2	0	0	0	2
OG0014558	2	0	0	0	2
OG0014559	2	0	0	0	2
OG0014560	1	1	0	0	2
OG0014561	1	0	1	0	2
OG0014562	2	0	0	0	2
OG0014563	1	0	1	0	2
OG0014564	1	1	0	0	2
OG0014565	1	1	0	0	2
OG0014566	1	1	0	0	2
OG0014567	1	1	0	0	2
OG0014568	1	0	1	0	2
OG0014569	1	1	0	0	2
OG0014570	1	1	0	0	2
OG0014571	1	1	0	0	2
OG0014572	1	0	1	0	2
OG0014573	1	0	1	0	2
OG0014574	1	0	0	1	2
OG0014575	1	1	0	0	2
OG0014576	1	1	0	0	2
OG0014577	1	1	0	0	2
OG0014578	1	1	0	0	2
OG0014579	1	1	0	0	2
OG0014580	2	0	0	0	2
OG0014581	1	1	0	0	2
OG0014582	1	1	0	0	2
OG0014583	2	0	0	0	2
OG0014584	1	1	0	0	2
OG0014585	2	0	0	0	2
OG0014586	1	1	0	0	2
OG0014587	2	0	0	0	2
OG0014588	1	1	0	0	2
OG0014589	1	1	0	0	2
OG0014590	1	1	0	0	2
OG0014591	1	1	0	0	2
OG0014592	1	1	0	0	2
OG0014593	1	1	0	0	2
OG0014594	1	1	0	0	2
OG0014595	1	1	0	0	2
OG0014596	1	1	0	0	2
OG0014597	1	0	1	0	2
OG0014598	1	1	0	0	2
OG0014599	1	1	0	0	2
OG0014600	2	0	0	0	2
OG0014601	1	1	0	0	2
OG0014602	1	1	0	0	2
OG0014603	1	1	0	0	2
OG0014604	2	0	0	0	2
OG0014605	1	1	0	0	2
OG0014606	1	0	1	0	2
OG0014607	1	0	1	0	2
OG0014608	1	0	1	0	2
OG0014609	1	1	0	0	2
OG0014610	2	0	0	0	2
OG0014611	2	0	0	0	2
OG0014612	1	1	0	0	2
OG0014613	1	0	1	0	2
OG0014614	1	0	1	0	2
OG0014615	1	0	1	0	2
OG0014616	1	1	0	0	2
OG0014617	1	0	1	0	2
OG0014618	1	1	0	0	2
OG0014619	1	1	0	0	2
OG0014620	2	0	0	0	2
OG0014621	1	1	0	0	2
OG0014622	2	0	0	0	2
OG0014623	1	0	1	0	2
OG0014624	1	1	0	0	2
OG0014625	1	1	0	0	2
OG0014626	1	0	1	0	2
OG0014627	2	0	0	0	2
OG0014628	2	0	0	0	2
OG0014629	1	1	0	0	2
OG0014630	1	1	0	0	2
OG0014631	1	1	0	0	2
OG0014632	1	1	0	0	2
OG0014633	2	0	0	0	2
OG0014634	1	1	0	0	2
OG0014635	2	0	0	0	2
OG0014636	1	1	0	0	2
OG0014637	1	1	0	0	2
OG0014638	1	1	0	0	2
OG0014639	1	0	1	0	2
OG0014640	1	1	0	0	2
OG0014641	2	0	0	0	2
OG0014642	1	1	0	0	2
OG0014643	2	0	0	0	2
OG0014644	1	1	0	0	2
OG0014645	1	0	0	1	2
OG0014646	1	1	0	0	2
OG0014647	1	1	0	0	2
OG0014648	1	1	0	0	2
OG0014649	1	0	1	0	2
OG0014650	1	1	0	0	2
OG0014651	1	0	1	0	2
OG0014652	2	0	0	0	2
OG0014653	1	0	1	0	2
OG0014654	1	1	0	0	2
OG0014655	1	1	0	0	2
OG0014656	1	1	0	0	2
OG0014657	1	1	0	0	2
OG0014658	1	0	1	0	2
OG0014659	2	0	0	0	2
OG0014660	1	1	0	0	2
OG0014661	1	1	0	0	2
OG0014662	1	1	0	0	2
OG0014663	1	1	0	0	2
OG0014664	1	1	0	0	2
OG0014665	2	0	0	0	2
OG0014666	1	1	0	0	2
OG0014667	1	1	0	0	2
OG0014668	1	1	0	0	2
OG0014669	1	0	1	0	2
OG0014670	2	0	0	0	2
OG0014671	1	1	0	0	2
OG0014672	2	0	0	0	2
OG0014673	1	1	0	0	2
OG0014674	1	1	0	0	2
OG0014675	1	0	1	0	2
OG0014676	1	0	1	0	2
OG0014677	1	1	0	0	2
OG0014678	2	0	0	0	2
OG0014679	1	1	0	0	2
OG0014680	1	1	0	0	2
OG0014681	2	0	0	0	2
OG0014682	1	0	1	0	2
OG0014683	2	0	0	0	2
OG0014684	1	1	0	0	2
OG0014685	1	1	0	0	2
OG0014686	2	0	0	0	2
OG0014687	1	1	0	0	2
OG0014688	2	0	0	0	2
OG0014689	1	1	0	0	2
OG0014690	2	0	0	0	2
OG0014691	1	0	1	0	2
OG0014692	1	0	1	0	2
OG0014693	2	0	0	0	2
OG0014694	2	0	0	0	2
OG0014695	1	0	1	0	2
OG0014696	1	1	0	0	2
OG0014697	1	1	0	0	2
OG0014698	2	0	0	0	2
OG0014699	2	0	0	0	2
OG0014700	1	1	0	0	2
OG0014701	1	1	0	0	2
OG0014702	1	1	0	0	2
OG0014703	1	1	0	0	2
OG0014704	1	1	0	0	2
OG0014705	1	1	0	0	2
OG0014706	1	1	0	0	2
OG0014707	2	0	0	0	2
OG0014708	1	1	0	0	2
OG0014709	1	1	0	0	2
OG0014710	2	0	0	0	2
OG0014711	1	1	0	0	2
OG0014712	1	0	1	0	2
OG0014713	2	0	0	0	2
OG0014714	2	0	0	0	2
OG0014715	1	1	0	0	2
OG0014716	1	1	0	0	2
OG0014717	1	0	1	0	2
OG0014718	1	0	1	0	2
OG0014719	1	1	0	0	2
OG0014720	1	1	0	0	2
OG0014721	1	0	1	0	2
OG0014722	1	1	0	0	2
OG0014723	1	0	1	0	2
OG0014724	1	0	1	0	2
OG0014725	1	0	1	0	2
OG0014726	1	0	1	0	2
OG0014727	2	0	0	0	2
OG0014728	1	1	0	0	2
OG0014729	1	0	1	0	2
OG0014730	2	0	0	0	2
OG0014731	1	1	0	0	2
OG0014732	1	1	0	0	2
OG0014733	1	1	0	0	2
OG0014734	2	0	0	0	2
OG0014735	1	1	0	0	2
OG0014736	1	0	1	0	2
OG0014737	1	1	0	0	2
OG0014738	1	1	0	0	2
OG0014739	2	0	0	0	2
OG0014740	1	1	0	0	2
OG0014741	1	1	0	0	2
OG0014742	1	0	1	0	2
OG0014743	1	1	0	0	2
OG0014744	1	1	0	0	2
OG0014745	1	0	1	0	2
OG0014746	1	0	1	0	2
OG0014747	1	1	0	0	2
OG0014748	1	1	0	0	2
OG0014749	2	0	0	0	2
OG0014750	2	0	0	0	2
OG0014751	1	1	0	0	2
OG0014752	1	0	0	1	2
OG0014753	1	1	0	0	2
OG0014754	1	1	0	0	2
OG0014755	1	1	0	0	2
OG0014756	1	1	0	0	2
OG0014757	1	1	0	0	2
OG0014758	1	1	0	0	2
OG0014759	1	0	1	0	2
OG0014760	1	0	0	1	2
OG0014761	1	1	0	0	2
OG0014762	1	0	0	1	2
OG0014763	1	1	0	0	2
OG0014764	2	0	0	0	2
OG0014765	1	1	0	0	2
OG0014766	1	1	0	0	2
OG0014767	1	0	1	0	2
OG0014768	1	0	0	1	2
OG0014769	1	1	0	0	2
OG0014770	2	0	0	0	2
OG0014771	1	1	0	0	2
OG0014772	1	1	0	0	2
OG0014773	1	0	1	0	2
OG0014774	1	1	0	0	2
OG0014775	2	0	0	0	2
OG0014776	1	0	1	0	2
OG0014777	2	0	0	0	2
OG0014778	1	1	0	0	2
OG0014779	1	1	0	0	2
OG0014780	1	1	0	0	2
OG0014781	1	0	1	0	2
OG0014782	1	1	0	0	2
OG0014783	1	0	1	0	2
OG0014784	1	1	0	0	2
OG0014785	2	0	0	0	2
OG0014786	1	1	0	0	2
OG0014787	1	1	0	0	2
OG0014788	2	0	0	0	2
OG0014789	1	0	1	0	2
OG0014790	1	1	0	0	2
OG0014791	1	1	0	0	2
OG0014792	1	1	0	0	2
OG0014793	1	0	1	0	2
OG0014794	1	1	0	0	2
OG0014795	1	1	0	0	2
OG0014796	1	1	0	0	2
OG0014797	1	0	0	1	2
OG0014798	1	1	0	0	2
OG0014799	2	0	0	0	2
OG0014800	1	0	1	0	2
OG0014801	2	0	0	0	2
OG0014802	1	0	0	1	2
OG0014803	1	0	1	0	2
OG0014804	2	0	0	0	2
OG0014805	1	0	1	0	2
OG0014806	2	0	0	0	2
OG0014807	1	1	0	0	2
OG0014808	1	1	0	0	2
OG0014809	2	0	0	0	2
OG0014810	1	0	1	0	2
OG0014811	1	0	1	0	2
OG0014812	1	0	1	0	2
OG0014813	1	1	0	0	2
OG0014814	1	1	0	0	2
OG0014815	1	1	0	0	2
OG0014816	2	0	0	0	2
OG0014817	2	0	0	0	2
OG0014818	1	1	0	0	2
OG0014819	1	0	1	0	2
OG0014820	1	1	0	0	2
OG0014821	2	0	0	0	2
OG0014822	1	1	0	0	2
OG0014823	1	1	0	0	2
OG0014824	2	0	0	0	2
OG0014825	2	0	0	0	2
OG0014826	1	1	0	0	2
OG0014827	1	1	0	0	2
OG0014828	1	1	0	0	2
OG0014829	2	0	0	0	2
OG0014830	1	0	1	0	2
OG0014831	1	1	0	0	2
OG0014832	1	1	0	0	2
OG0014833	1	1	0	0	2
OG0014834	2	0	0	0	2
OG0014835	1	0	1	0	2
OG0014836	1	1	0	0	2
OG0014837	1	1	0	0	2
OG0014838	2	0	0	0	2
OG0014839	1	1	0	0	2
OG0014840	1	1	0	0	2
OG0014841	2	0	0	0	2
OG0014842	1	1	0	0	2
OG0014843	1	0	0	1	2
OG0014844	2	0	0	0	2
OG0014845	1	1	0	0	2
OG0014846	1	1	0	0	2
OG0014847	1	1	0	0	2
OG0014848	2	0	0	0	2
OG0014849	1	1	0	0	2
OG0014850	1	0	1	0	2
OG0014851	1	1	0	0	2
OG0014852	1	1	0	0	2
OG0014853	2	0	0	0	2
OG0014854	1	1	0	0	2
OG0014855	1	0	1	0	2
OG0014856	1	1	0	0	2
OG0014857	1	0	0	1	2
OG0014858	1	0	1	0	2
OG0014859	2	0	0	0	2
OG0014860	2	0	0	0	2
OG0014861	1	1	0	0	2
OG0014862	2	0	0	0	2
OG0014863	1	1	0	0	2
OG0014864	1	1	0	0	2
OG0014865	1	1	0	0	2
OG0014866	2	0	0	0	2
OG0014867	1	1	0	0	2
OG0014868	2	0	0	0	2
OG0014869	1	1	0	0	2
OG0014870	1	1	0	0	2
OG0014871	2	0	0	0	2
OG0014872	1	1	0	0	2
OG0014873	1	1	0	0	2
OG0014874	2	0	0	0	2
OG0014875	1	1	0	0	2
OG0014876	1	1	0	0	2
OG0014877	1	1	0	0	2
OG0014878	1	1	0	0	2
OG0014879	1	1	0	0	2
OG0014880	1	1	0	0	2
OG0014881	1	1	0	0	2
OG0014882	2	0	0	0	2
OG0014883	1	1	0	0	2
OG0014884	1	0	0	1	2
OG0014885	1	1	0	0	2
OG0014886	2	0	0	0	2
OG0014887	1	0	1	0	2
OG0014888	2	0	0	0	2
OG0014889	1	0	1	0	2
OG0014890	1	1	0	0	2
OG0014891	1	1	0	0	2
OG0014892	1	1	0	0	2
OG0014893	1	1	0	0	2
OG0014894	1	0	1	0	2
OG0014895	1	1	0	0	2
OG0014896	2	0	0	0	2
OG0014897	1	1	0	0	2
OG0014898	1	1	0	0	2
OG0014899	1	0	1	0	2
OG0014900	1	1	0	0	2
OG0014901	2	0	0	0	2
OG0014902	1	0	1	0	2
OG0014903	2	0	0	0	2
OG0014904	1	1	0	0	2
OG0014905	1	0	1	0	2
OG0014906	1	1	0	0	2
OG0014907	2	0	0	0	2
OG0014908	1	1	0	0	2
OG0014909	2	0	0	0	2
OG0014910	2	0	0	0	2
OG0014911	1	1	0	0	2
OG0014912	2	0	0	0	2
OG0014913	1	0	0	1	2
OG0014914	2	0	0	0	2
OG0014915	1	1	0	0	2
OG0014916	1	1	0	0	2
OG0014917	1	0	1	0	2
OG0014918	1	0	1	0	2
OG0014919	2	0	0	0	2
OG0014920	1	0	1	0	2
OG0014921	2	0	0	0	2
OG0014922	1	0	1	0	2
OG0014923	1	0	0	1	2
OG0014924	1	0	0	1	2
OG0014925	1	1	0	0	2
OG0014926	1	0	1	0	2
OG0014927	1	1	0	0	2
OG0014928	2	0	0	0	2
OG0014929	1	0	1	0	2
OG0014930	1	1	0	0	2
OG0014931	1	1	0	0	2
OG0014932	1	1	0	0	2
OG0014933	1	1	0	0	2
OG0014934	1	1	0	0	2
OG0014935	1	1	0	0	2
OG0014936	1	1	0	0	2
OG0014937	2	0	0	0	2
OG0014938	2	0	0	0	2
OG0014939	1	1	0	0	2
OG0014940	1	0	0	1	2
OG0014941	1	1	0	0	2
OG0014942	1	1	0	0	2
OG0014943	1	1	0	0	2
OG0014944	2	0	0	0	2
OG0014945	1	0	1	0	2
OG0014946	1	0	1	0	2
OG0014947	1	1	0	0	2
OG0014948	1	1	0	0	2
OG0014949	2	0	0	0	2
OG0014950	1	1	0	0	2
OG0014951	1	1	0	0	2
OG0014952	2	0	0	0	2
OG0014953	1	0	1	0	2
OG0014954	1	1	0	0	2
OG0014955	1	0	1	0	2
OG0014956	1	1	0	0	2
OG0014957	1	1	0	0	2
OG0014958	1	1	0	0	2
OG0014959	2	0	0	0	2
OG0014960	1	0	1	0	2
OG0014961	1	1	0	0	2
OG0014962	1	1	0	0	2
OG0014963	1	0	1	0	2
OG0014964	1	1	0	0	2
OG0014965	1	1	0	0	2
OG0014966	2	0	0	0	2
OG0014967	2	0	0	0	2
OG0014968	2	0	0	0	2
OG0014969	2	0	0	0	2
OG0014970	1	0	1	0	2
OG0014971	1	1	0	0	2
OG0014972	1	0	1	0	2
OG0014973	1	1	0	0	2
OG0014974	1	1	0	0	2
OG0014975	1	1	0	0	2
OG0014976	1	1	0	0	2
OG0014977	1	0	1	0	2
OG0014978	1	0	1	0	2
OG0014979	1	1	0	0	2
OG0014980	2	0	0	0	2
OG0014981	2	0	0	0	2
OG0014982	2	0	0	0	2
OG0014983	2	0	0	0	2
OG0014984	1	1	0	0	2
OG0014985	1	1	0	0	2
OG0014986	1	0	1	0	2
OG0014987	1	1	0	0	2
OG0014988	2	0	0	0	2
OG0014989	1	1	0	0	2
OG0014990	1	1	0	0	2
OG0014991	2	0	0	0	2
OG0014992	1	1	0	0	2
OG0014993	1	1	0	0	2
OG0014994	1	1	0	0	2
OG0014995	2	0	0	0	2
OG0014996	1	1	0	0	2
OG0014997	2	0	0	0	2
OG0014998	1	1	0	0	2
OG0014999	1	1	0	0	2
OG0015000	1	0	0	1	2
OG0015001	1	1	0	0	2
OG0015002	2	0	0	0	2
OG0015003	1	0	1	0	2
OG0015004	1	0	1	0	2
OG0015005	2	0	0	0	2
OG0015006	1	0	1	0	2
OG0015007	1	1	0	0	2
OG0015008	1	1	0	0	2
OG0015009	1	0	1	0	2
OG0015010	1	0	1	0	2
OG0015011	1	1	0	0	2
OG0015012	1	1	0	0	2
OG0015013	2	0	0	0	2
OG0015014	1	1	0	0	2
OG0015015	1	1	0	0	2
OG0015016	1	1	0	0	2
OG0015017	1	0	1	0	2
OG0015018	2	0	0	0	2
OG0015019	1	0	1	0	2
OG0015020	2	0	0	0	2
OG0015021	1	1	0	0	2
OG0015022	1	0	1	0	2
OG0015023	1	0	1	0	2
OG0015024	1	0	1	0	2
OG0015025	1	1	0	0	2
OG0015026	1	1	0	0	2
OG0015027	2	0	0	0	2
OG0015028	1	1	0	0	2
OG0015029	1	1	0	0	2
OG0015030	2	0	0	0	2
OG0015031	2	0	0	0	2
OG0015032	1	1	0	0	2
OG0015033	1	1	0	0	2
OG0015034	1	1	0	0	2
OG0015035	2	0	0	0	2
OG0015036	1	1	0	0	2
OG0015037	1	1	0	0	2
OG0015038	1	0	1	0	2
OG0015039	1	1	0	0	2
OG0015040	1	1	0	0	2
OG0015041	1	1	0	0	2
OG0015042	1	1	0	0	2
OG0015043	1	1	0	0	2
OG0015044	1	0	0	1	2
OG0015045	1	1	0	0	2
OG0015046	1	1	0	0	2
OG0015047	1	1	0	0	2
OG0015048	2	0	0	0	2
OG0015049	1	0	1	0	2
OG0015050	2	0	0	0	2
OG0015051	1	1	0	0	2
OG0015052	1	1	0	0	2
OG0015053	1	1	0	0	2
OG0015054	1	1	0	0	2
OG0015055	1	1	0	0	2
OG0015056	1	1	0	0	2
OG0015057	1	1	0	0	2
OG0015058	1	1	0	0	2
OG0015059	1	0	1	0	2
OG0015060	1	1	0	0	2
OG0015061	1	0	1	0	2
OG0015062	1	1	0	0	2
OG0015063	2	0	0	0	2
OG0015064	1	1	0	0	2
OG0015065	1	1	0	0	2
OG0015066	1	1	0	0	2
OG0015067	2	0	0	0	2
OG0015068	1	1	0	0	2
OG0015069	2	0	0	0	2
OG0015070	1	1	0	0	2
OG0015071	1	1	0	0	2
OG0015072	2	0	0	0	2
OG0015073	1	1	0	0	2
OG0015074	1	0	1	0	2
OG0015075	1	0	1	0	2
OG0015076	1	1	0	0	2
OG0015077	2	0	0	0	2
OG0015078	1	1	0	0	2
OG0015079	2	0	0	0	2
OG0015080	1	1	0	0	2
OG0015081	1	0	1	0	2
OG0015082	2	0	0	0	2
OG0015083	2	0	0	0	2
OG0015084	1	0	1	0	2
OG0015085	1	0	1	0	2
OG0015086	1	1	0	0	2
OG0015087	1	0	1	0	2
OG0015088	1	1	0	0	2
OG0015089	2	0	0	0	2
OG0015090	1	1	0	0	2
OG0015091	1	1	0	0	2
OG0015092	1	1	0	0	2
OG0015093	1	1	0	0	2
OG0015094	1	0	1	0	2
OG0015095	1	1	0	0	2
OG0015096	1	1	0	0	2
OG0015097	2	0	0	0	2
OG0015098	1	1	0	0	2
OG0015099	1	0	1	0	2
OG0015100	1	0	1	0	2
OG0015101	1	1	0	0	2
OG0015102	2	0	0	0	2
OG0015103	1	1	0	0	2
OG0015104	1	1	0	0	2
OG0015105	2	0	0	0	2
OG0015106	1	1	0	0	2
OG0015107	1	0	1	0	2
OG0015108	1	1	0	0	2
OG0015109	1	1	0	0	2
OG0015110	1	0	0	1	2
OG0015111	1	1	0	0	2
OG0015112	2	0	0	0	2
OG0015113	2	0	0	0	2
OG0015114	1	1	0	0	2
OG0015115	1	1	0	0	2
OG0015116	2	0	0	0	2
OG0015117	1	0	1	0	2
OG0015118	1	0	1	0	2
OG0015119	1	0	1	0	2
OG0015120	2	0	0	0	2
OG0015121	1	1	0	0	2
OG0015122	1	0	1	0	2
OG0015123	1	1	0	0	2
OG0015124	2	0	0	0	2
OG0015125	1	1	0	0	2
OG0015126	1	0	1	0	2
OG0015127	1	1	0	0	2
OG0015128	1	1	0	0	2
OG0015129	1	0	1	0	2
OG0015130	1	0	1	0	2
OG0015131	2	0	0	0	2
OG0015132	1	0	0	1	2
OG0015133	2	0	0	0	2
OG0015134	1	1	0	0	2
OG0015135	1	0	1	0	2
OG0015136	1	0	1	0	2
OG0015137	1	1	0	0	2
OG0015138	2	0	0	0	2
OG0015139	1	1	0	0	2
OG0015140	1	1	0	0	2
OG0015141	1	1	0	0	2
OG0015142	1	1	0	0	2
OG0015143	1	0	1	0	2
OG0015144	1	1	0	0	2
OG0015145	2	0	0	0	2
OG0015146	1	1	0	0	2
OG0015147	2	0	0	0	2
OG0015148	1	0	1	0	2
OG0015149	1	1	0	0	2
OG0015150	1	1	0	0	2
OG0015151	2	0	0	0	2
OG0015152	1	1	0	0	2
OG0015153	1	1	0	0	2
OG0015154	1	0	1	0	2
OG0015155	1	1	0	0	2
OG0015156	2	0	0	0	2
OG0015157	1	1	0	0	2
OG0015158	1	1	0	0	2
OG0015159	1	1	0	0	2
OG0015160	1	1	0	0	2
OG0015161	2	0	0	0	2
OG0015162	2	0	0	0	2
OG0015163	2	0	0	0	2
OG0015164	1	1	0	0	2
OG0015165	2	0	0	0	2
OG0015166	1	0	1	0	2
OG0015167	1	0	1	0	2
OG0015168	2	0	0	0	2
OG0015169	1	1	0	0	2
OG0015170	1	0	0	1	2
OG0015171	1	1	0	0	2
OG0015172	2	0	0	0	2
OG0015173	1	0	1	0	2
OG0015174	1	1	0	0	2
OG0015175	1	1	0	0	2
OG0015176	2	0	0	0	2
OG0015177	1	0	1	0	2
OG0015178	1	1	0	0	2
OG0015179	1	1	0	0	2
OG0015180	2	0	0	0	2
OG0015181	2	0	0	0	2
OG0015182	2	0	0	0	2
OG0015183	1	1	0	0	2
OG0015184	1	1	0	0	2
OG0015185	1	1	0	0	2
OG0015186	1	1	0	0	2
OG0015187	1	1	0	0	2
OG0015188	1	1	0	0	2
OG0015189	1	1	0	0	2
OG0015190	1	1	0	0	2
OG0015191	2	0	0	0	2
OG0015192	1	1	0	0	2
OG0015193	2	0	0	0	2
OG0015194	1	1	0	0	2
OG0015195	1	1	0	0	2
OG0015196	2	0	0	0	2
OG0015197	1	0	1	0	2
OG0015198	2	0	0	0	2
OG0015199	1	0	1	0	2
OG0015200	2	0	0	0	2
OG0015201	1	0	1	0	2
OG0015202	2	0	0	0	2
OG0015203	1	0	1	0	2
OG0015204	1	1	0	0	2
OG0015205	1	1	0	0	2
OG0015206	1	1	0	0	2
OG0015207	2	0	0	0	2
OG0015208	1	0	1	0	2
OG0015209	1	1	0	0	2
OG0015210	1	0	1	0	2
OG0015211	1	0	1	0	2
OG0015212	1	0	0	1	2
OG0015213	1	1	0	0	2
OG0015214	1	1	0	0	2
OG0015215	1	1	0	0	2
OG0015216	1	1	0	0	2
OG0015217	1	0	1	0	2
OG0015218	1	1	0	0	2
OG0015219	2	0	0	0	2
OG0015220	1	1	0	0	2
OG0015221	1	1	0	0	2
OG0015222	1	1	0	0	2
OG0015223	2	0	0	0	2
OG0015224	1	0	1	0	2
OG0015225	1	0	1	0	2
OG0015226	2	0	0	0	2
OG0015227	1	1	0	0	2
OG0015228	1	0	1	0	2
OG0015229	1	1	0	0	2
OG0015230	1	1	0	0	2
OG0015231	1	0	0	1	2
OG0015232	1	1	0	0	2
OG0015233	1	0	1	0	2
OG0015234	2	0	0	0	2
OG0015235	2	0	0	0	2
OG0015236	2	0	0	0	2
OG0015237	1	1	0	0	2
OG0015238	1	0	1	0	2
OG0015239	1	1	0	0	2
OG0015240	1	1	0	0	2
OG0015241	2	0	0	0	2
OG0015242	2	0	0	0	2
OG0015243	1	0	1	0	2
OG0015244	1	1	0	0	2
OG0015245	1	1	0	0	2
OG0015246	1	1	0	0	2
OG0015247	1	0	1	0	2
OG0015248	1	1	0	0	2
OG0015249	1	1	0	0	2
OG0015250	2	0	0	0	2
OG0015251	1	1	0	0	2
OG0015252	1	0	1	0	2
OG0015253	1	0	1	0	2
OG0015254	1	0	0	1	2
OG0015255	2	0	0	0	2
OG0015256	2	0	0	0	2
OG0015257	1	1	0	0	2
OG0015258	1	0	1	0	2
OG0015259	2	0	0	0	2
OG0015260	1	1	0	0	2
OG0015261	1	0	1	0	2
OG0015262	1	1	0	0	2
OG0015263	1	0	1	0	2
OG0015264	1	1	0	0	2
OG0015265	1	1	0	0	2
OG0015266	1	1	0	0	2
OG0015267	1	1	0	0	2
OG0015268	1	1	0	0	2
OG0015269	1	1	0	0	2
OG0015270	2	0	0	0	2
OG0015271	1	1	0	0	2
OG0015272	2	0	0	0	2
OG0015273	1	1	0	0	2
OG0015274	1	0	1	0	2
OG0015275	1	0	1	0	2
OG0015276	1	1	0	0	2
OG0015277	2	0	0	0	2
OG0015278	1	1	0	0	2
OG0015279	1	1	0	0	2
OG0015280	1	1	0	0	2
OG0015281	1	0	1	0	2
OG0015282	1	1	0	0	2
OG0015283	1	1	0	0	2
OG0015284	1	0	1	0	2
OG0015285	1	1	0	0	2
OG0015286	2	0	0	0	2
OG0015287	1	1	0	0	2
OG0015288	1	1	0	0	2
OG0015289	2	0	0	0	2
OG0015290	2	0	0	0	2
OG0015291	1	1	0	0	2
OG0015292	1	0	1	0	2
OG0015293	1	1	0	0	2
OG0015294	1	0	1	0	2
OG0015295	1	1	0	0	2
OG0015296	1	1	0	0	2
OG0015297	1	1	0	0	2
OG0015298	1	1	0	0	2
OG0015299	1	1	0	0	2
OG0015300	1	0	1	0	2
OG0015301	2	0	0	0	2
OG0015302	1	1	0	0	2
OG0015303	1	1	0	0	2
OG0015304	2	0	0	0	2
OG0015305	1	1	0	0	2
OG0015306	1	0	0	1	2
OG0015307	1	0	1	0	2
OG0015308	1	1	0	0	2
OG0015309	1	1	0	0	2
OG0015310	1	0	1	0	2
OG0015311	2	0	0	0	2
OG0015312	2	0	0	0	2
OG0015313	1	1	0	0	2
OG0015314	1	1	0	0	2
OG0015315	1	1	0	0	2
OG0015316	1	1	0	0	2
OG0015317	1	1	0	0	2
OG0015318	1	1	0	0	2
OG0015319	1	1	0	0	2
OG0015320	1	1	0	0	2
OG0015321	1	1	0	0	2
OG0015322	1	1	0	0	2
OG0015323	1	1	0	0	2
OG0015324	1	0	1	0	2
OG0015325	1	1	0	0	2
OG0015326	1	1	0	0	2
OG0015327	2	0	0	0	2
OG0015328	1	0	1	0	2
OG0015329	1	1	0	0	2
OG0015330	1	0	1	0	2
OG0015331	1	1	0	0	2
OG0015332	2	0	0	0	2
OG0015333	2	0	0	0	2
OG0015334	1	1	0	0	2
OG0015335	1	1	0	0	2
OG0015336	1	1	0	0	2
OG0015337	1	1	0	0	2
OG0015338	1	1	0	0	2
OG0015339	2	0	0	0	2
OG0015340	2	0	0	0	2
OG0015341	1	1	0	0	2
OG0015342	1	1	0	0	2
OG0015343	2	0	0	0	2
OG0015344	2	0	0	0	2
OG0015345	1	1	0	0	2
OG0015346	1	1	0	0	2
OG0015347	1	1	0	0	2
OG0015348	1	1	0	0	2
OG0015349	1	0	0	1	2
OG0015350	1	1	0	0	2
OG0015351	2	0	0	0	2
OG0015352	1	0	1	0	2
OG0015353	1	1	0	0	2
OG0015354	1	1	0	0	2
OG0015355	1	1	0	0	2
OG0015356	1	1	0	0	2
OG0015357	1	1	0	0	2
OG0015358	1	0	1	0	2
OG0015359	2	0	0	0	2
OG0015360	1	0	1	0	2
OG0015361	1	0	1	0	2
OG0015362	1	0	1	0	2
OG0015363	1	0	1	0	2
OG0015364	1	0	1	0	2
OG0015365	1	0	1	0	2
OG0015366	1	0	1	0	2
OG0015367	1	1	0	0	2
OG0015368	1	0	0	1	2
OG0015369	2	0	0	0	2
OG0015370	1	1	0	0	2
OG0015371	1	1	0	0	2
OG0015372	1	1	0	0	2
OG0015373	1	1	0	0	2
OG0015374	1	1	0	0	2
OG0015375	2	0	0	0	2
OG0015376	1	1	0	0	2
OG0015377	1	1	0	0	2
OG0015378	2	0	0	0	2
OG0015379	1	1	0	0	2
OG0015380	2	0	0	0	2
OG0015381	1	1	0	0	2
OG0015382	1	1	0	0	2
OG0015383	2	0	0	0	2
OG0015384	2	0	0	0	2
OG0015385	1	1	0	0	2
OG0015386	1	1	0	0	2
OG0015387	1	1	0	0	2
OG0015388	1	1	0	0	2
OG0015389	1	1	0	0	2
OG0015390	1	1	0	0	2
OG0015391	1	0	1	0	2
OG0015392	1	1	0	0	2
OG0015393	1	0	0	1	2
OG0015394	1	1	0	0	2
OG0015395	1	1	0	0	2
OG0015396	1	1	0	0	2
OG0015397	1	1	0	0	2
OG0015398	1	1	0	0	2
OG0015399	1	1	0	0	2
OG0015400	1	1	0	0	2
OG0015401	1	1	0	0	2
OG0015402	2	0	0	0	2
OG0015403	2	0	0	0	2
OG0015404	1	0	1	0	2
OG0015405	1	0	0	1	2
OG0015406	1	1	0	0	2
OG0015407	2	0	0	0	2
OG0015408	1	1	0	0	2
OG0015409	1	1	0	0	2
OG0015410	1	1	0	0	2
OG0015411	1	1	0	0	2
OG0015412	1	1	0	0	2
OG0015413	2	0	0	0	2
OG0015414	2	0	0	0	2
OG0015415	2	0	0	0	2
OG0015416	1	1	0	0	2
OG0015417	2	0	0	0	2
OG0015418	1	1	0	0	2
OG0015419	1	0	1	0	2
OG0015420	1	1	0	0	2
OG0015421	1	0	1	0	2
OG0015422	2	0	0	0	2
OG0015423	2	0	0	0	2
OG0015424	1	1	0	0	2
OG0015425	1	1	0	0	2
OG0015426	1	1	0	0	2
OG0015427	1	1	0	0	2
OG0015428	2	0	0	0	2
OG0015429	1	0	1	0	2
OG0015430	1	1	0	0	2
OG0015431	1	1	0	0	2
OG0015432	1	1	0	0	2
OG0015433	1	0	0	1	2
OG0015434	1	1	0	0	2
OG0015435	1	0	1	0	2
OG0015436	1	0	1	0	2
OG0015437	2	0	0	0	2
OG0015438	1	0	1	0	2
OG0015439	1	1	0	0	2
OG0015440	1	0	1	0	2
OG0015441	2	0	0	0	2
OG0015442	1	1	0	0	2
OG0015443	1	1	0	0	2
OG0015444	1	0	1	0	2
OG0015445	1	1	0	0	2
OG0015446	1	0	1	0	2
OG0015447	1	1	0	0	2
OG0015448	1	1	0	0	2
OG0015449	1	1	0	0	2
OG0015450	1	1	0	0	2
OG0015451	1	1	0	0	2
OG0015452	2	0	0	0	2
OG0015453	1	0	1	0	2
OG0015454	1	0	0	1	2
OG0015455	1	1	0	0	2
OG0015456	2	0	0	0	2
OG0015457	1	0	1	0	2
OG0015458	2	0	0	0	2
OG0015459	1	1	0	0	2
OG0015460	1	1	0	0	2
OG0015461	2	0	0	0	2
OG0015462	1	0	1	0	2
OG0015463	1	1	0	0	2
OG0015464	1	1	0	0	2
OG0015465	2	0	0	0	2
OG0015466	2	0	0	0	2
OG0015467	2	0	0	0	2
OG0015468	1	1	0	0	2
OG0015469	2	0	0	0	2
OG0015470	1	1	0	0	2
OG0015471	1	1	0	0	2
OG0015472	1	1	0	0	2
OG0015473	1	1	0	0	2
OG0015474	2	0	0	0	2
OG0015475	2	0	0	0	2
OG0015476	2	0	0	0	2
OG0015477	1	0	1	0	2
OG0015478	1	1	0	0	2
OG0015479	2	0	0	0	2
OG0015480	1	1	0	0	2
OG0015481	1	1	0	0	2
OG0015482	2	0	0	0	2
OG0015483	1	1	0	0	2
OG0015484	1	1	0	0	2
OG0015485	1	0	1	0	2
OG0015486	1	1	0	0	2
OG0015487	1	1	0	0	2
OG0015488	1	1	0	0	2
OG0015489	1	0	1	0	2
OG0015490	1	1	0	0	2
OG0015491	1	0	0	1	2
OG0015492	1	0	0	1	2
OG0015493	1	0	1	0	2
OG0015494	1	1	0	0	2
OG0015495	1	1	0	0	2
OG0015496	1	1	0	0	2
OG0015497	1	1	0	0	2
OG0015498	1	0	1	0	2
OG0015499	2	0	0	0	2
OG0015500	1	0	0	1	2
OG0015501	1	1	0	0	2
OG0015502	1	0	1	0	2
OG0015503	1	1	0	0	2
OG0015504	1	0	1	0	2
OG0015505	1	0	1	0	2
OG0015506	1	1	0	0	2
OG0015507	1	1	0	0	2
OG0015508	1	0	1	0	2
OG0015509	1	1	0	0	2
OG0015510	1	1	0	0	2
OG0015511	1	1	0	0	2
OG0015512	2	0	0	0	2
OG0015513	1	0	1	0	2
OG0015514	2	0	0	0	2
OG0015515	1	0	1	0	2
OG0015516	2	0	0	0	2
OG0015517	1	0	1	0	2
OG0015518	2	0	0	0	2
OG0015519	2	0	0	0	2
OG0015520	1	1	0	0	2
OG0015521	1	1	0	0	2
OG0015522	1	1	0	0	2
OG0015523	1	0	1	0	2
OG0015524	1	1	0	0	2
OG0015525	1	1	0	0	2
OG0015526	1	0	0	1	2
OG0015527	1	1	0	0	2
OG0015528	1	0	1	0	2
OG0015529	2	0	0	0	2
OG0015530	1	0	0	1	2
OG0015531	2	0	0	0	2
OG0015532	1	0	1	0	2
OG0015533	1	1	0	0	2
OG0015534	2	0	0	0	2
OG0015535	2	0	0	0	2
OG0015536	2	0	0	0	2
OG0015537	1	1	0	0	2
OG0015538	1	0	0	1	2
OG0015539	1	1	0	0	2
OG0015540	2	0	0	0	2
OG0015541	1	1	0	0	2
OG0015542	2	0	0	0	2
OG0015543	1	1	0	0	2
OG0015544	1	1	0	0	2
OG0015545	1	1	0	0	2
OG0015546	1	1	0	0	2
OG0015547	2	0	0	0	2
OG0015548	1	1	0	0	2
OG0015549	2	0	0	0	2
OG0015550	2	0	0	0	2
OG0015551	1	1	0	0	2
OG0015552	1	1	0	0	2
OG0015553	2	0	0	0	2
OG0015554	1	1	0	0	2
OG0015555	1	1	0	0	2
OG0015556	1	1	0	0	2
OG0015557	1	1	0	0	2
OG0015558	1	1	0	0	2
OG0015559	2	0	0	0	2
OG0015560	1	1	0	0	2
OG0015561	1	1	0	0	2
OG0015562	1	0	1	0	2
OG0015563	1	1	0	0	2
OG0015564	1	1	0	0	2
OG0015565	1	1	0	0	2
OG0015566	1	1	0	0	2
OG0015567	1	0	1	0	2
OG0015568	1	1	0	0	2
OG0015569	1	1	0	0	2
OG0015570	2	0	0	0	2
OG0015571	1	0	0	1	2
OG0015572	2	0	0	0	2
OG0015573	1	1	0	0	2
OG0015574	2	0	0	0	2
OG0015575	1	0	1	0	2
OG0015576	1	1	0	0	2
OG0015577	2	0	0	0	2
OG0015578	1	0	1	0	2
OG0015579	1	0	1	0	2
OG0015580	1	1	0	0	2
OG0015581	1	1	0	0	2
OG0015582	1	0	1	0	2
OG0015583	1	1	0	0	2
OG0015584	1	1	0	0	2
OG0015585	1	0	1	0	2
OG0015586	1	1	0	0	2
OG0015587	1	1	0	0	2
OG0015588	1	0	1	0	2
OG0015589	1	1	0	0	2
OG0015590	1	0	1	0	2
OG0015591	1	1	0	0	2
OG0015592	1	1	0	0	2
OG0015593	1	0	1	0	2
OG0015594	1	0	1	0	2
OG0015595	1	0	1	0	2
OG0015596	2	0	0	0	2
OG0015597	1	0	1	0	2
OG0015598	1	1	0	0	2
OG0015599	1	0	1	0	2
OG0015600	1	0	1	0	2
OG0015601	1	0	1	0	2
OG0015602	1	1	0	0	2
OG0015603	1	0	1	0	2
OG0015604	1	1	0	0	2
OG0015605	1	0	1	0	2
OG0015606	1	0	1	0	2
OG0015607	1	1	0	0	2
OG0015608	1	1	0	0	2
OG0015609	1	1	0	0	2
OG0015610	1	0	1	0	2
OG0015611	1	1	0	0	2
OG0015612	1	0	1	0	2
OG0015613	1	1	0	0	2
OG0015614	1	1	0	0	2
OG0015615	1	0	1	0	2
OG0015616	1	0	1	0	2
OG0015617	1	1	0	0	2
OG0015618	2	0	0	0	2
OG0015619	2	0	0	0	2
OG0015620	1	1	0	0	2
OG0015621	2	0	0	0	2
OG0015622	1	1	0	0	2
OG0015623	2	0	0	0	2
OG0015624	1	0	1	0	2
OG0015625	1	1	0	0	2
OG0015626	2	0	0	0	2
OG0015627	1	1	0	0	2
OG0015628	1	0	1	0	2
OG0015629	2	0	0	0	2
OG0015630	1	1	0	0	2
OG0015631	1	0	0	1	2
OG0015632	1	1	0	0	2
OG0015633	1	0	1	0	2
OG0015634	1	1	0	0	2
OG0015635	1	1	0	0	2
OG0015636	2	0	0	0	2
OG0015637	1	1	0	0	2
OG0015638	1	1	0	0	2
OG0015639	1	1	0	0	2
OG0015640	1	0	1	0	2
OG0015641	1	1	0	0	2
OG0015642	1	0	0	1	2
OG0015643	2	0	0	0	2
OG0015644	1	0	1	0	2
OG0015645	1	1	0	0	2
OG0015646	1	0	1	0	2
OG0015647	2	0	0	0	2
OG0015648	1	0	1	0	2
OG0015649	1	1	0	0	2
OG0015650	1	0	1	0	2
OG0015651	1	1	0	0	2
OG0015652	1	1	0	0	2
OG0015653	1	0	0	1	2
OG0015654	1	1	0	0	2
OG0015655	1	0	1	0	2
OG0015656	1	0	1	0	2
OG0015657	2	0	0	0	2
OG0015658	1	1	0	0	2
OG0015659	1	0	1	0	2
OG0015660	2	0	0	0	2
OG0015661	1	1	0	0	2
OG0015662	1	1	0	0	2
OG0015663	1	0	1	0	2
OG0015664	1	1	0	0	2
OG0015665	1	0	1	0	2
OG0015666	1	1	0	0	2
OG0015667	1	1	0	0	2
OG0015668	1	1	0	0	2
OG0015669	1	0	1	0	2
OG0015670	1	0	0	1	2
OG0015671	2	0	0	0	2
OG0015672	1	0	1	0	2
OG0015673	2	0	0	0	2
OG0015674	1	1	0	0	2
OG0015675	2	0	0	0	2
OG0015676	2	0	0	0	2
OG0015677	1	1	0	0	2
OG0015678	1	0	1	0	2
OG0015679	1	1	0	0	2
OG0015680	1	0	1	0	2
OG0015681	1	1	0	0	2
OG0015682	1	1	0	0	2
OG0015683	1	0	1	0	2
OG0015684	1	1	0	0	2
OG0015685	1	0	1	0	2
OG0015686	1	0	1	0	2
OG0015687	1	1	0	0	2
OG0015688	1	1	0	0	2
OG0015689	1	1	0	0	2
OG0015690	1	0	0	1	2
OG0015691	2	0	0	0	2
OG0015692	1	1	0	0	2
OG0015693	1	0	1	0	2
OG0015694	1	0	1	0	2
OG0015695	1	1	0	0	2
OG0015696	1	1	0	0	2
OG0015697	1	1	0	0	2
OG0015698	2	0	0	0	2
OG0015699	1	0	0	1	2
OG0015700	1	1	0	0	2
OG0015701	1	1	0	0	2
OG0015702	1	1	0	0	2
OG0015703	1	0	1	0	2
OG0015704	1	1	0	0	2
OG0015705	1	1	0	0	2
OG0015706	1	0	0	1	2
OG0015707	1	0	1	0	2
OG0015708	1	0	1	0	2
OG0015709	1	1	0	0	2
OG0015710	1	1	0	0	2
OG0015711	1	0	1	0	2
OG0015712	1	1	0	0	2
OG0015713	1	0	1	0	2
OG0015714	1	1	0	0	2
OG0015715	1	1	0	0	2
OG0015716	1	1	0	0	2
OG0015717	1	1	0	0	2
OG0015718	1	1	0	0	2
OG0015719	1	1	0	0	2
OG0015720	1	1	0	0	2
OG0015721	1	1	0	0	2
OG0015722	1	1	0	0	2
OG0015723	0	1	1	0	2
OG0015724	0	2	0	0	2
OG0015725	0	2	0	0	2
OG0015726	0	1	1	0	2
OG0015727	0	1	1	0	2
OG0015728	0	1	1	0	2
OG0015729	0	2	0	0	2
OG0015730	0	1	1	0	2
OG0015731	0	1	1	0	2
OG0015732	0	1	1	0	2
OG0015733	0	1	1	0	2
OG0015734	0	1	1	0	2
OG0015735	0	1	1	0	2
OG0015736	0	2	0	0	2
OG0015737	0	1	1	0	2
OG0015738	0	1	1	0	2
OG0015739	0	1	1	0	2
OG0015740	0	1	0	1	2
OG0015741	0	1	1	0	2
OG0015742	0	1	1	0	2
OG0015743	0	1	1	0	2
OG0015744	0	2	0	0	2
OG0015745	0	1	1	0	2
OG0015746	0	1	1	0	2
OG0015747	0	2	0	0	2
OG0015748	0	1	1	0	2
OG0015749	0	1	1	0	2
OG0015750	0	2	0	0	2
OG0015751	0	1	1	0	2
OG0015752	0	1	1	0	2
OG0015753	0	1	1	0	2
OG0015754	0	1	1	0	2
OG0015755	0	1	1	0	2
OG0015756	0	2	0	0	2
OG0015757	0	2	0	0	2
OG0015758	0	1	1	0	2
OG0015759	0	2	0	0	2
OG0015760	0	1	1	0	2
OG0015761	0	1	1	0	2
OG0015762	0	1	1	0	2
OG0015763	0	1	1	0	2
OG0015764	0	1	1	0	2
OG0015765	0	1	1	0	2
OG0015766	0	1	1	0	2
OG0015767	0	2	0	0	2
OG0015768	0	1	0	1	2
OG0015769	0	2	0	0	2
OG0015770	0	1	1	0	2
OG0015771	0	1	0	1	2
OG0015772	0	2	0	0	2
OG0015773	0	2	0	0	2
OG0015774	0	2	0	0	2
OG0015775	0	1	1	0	2
OG0015776	0	1	1	0	2
OG0015777	0	1	1	0	2
OG0015778	0	1	1	0	2
OG0015779	0	1	1	0	2
OG0015780	0	1	1	0	2
OG0015781	0	2	0	0	2
OG0015782	0	2	0	0	2
OG0015783	0	2	0	0	2
OG0015784	0	1	1	0	2
OG0015785	0	2	0	0	2
OG0015786	0	1	1	0	2
OG0015787	0	1	1	0	2
OG0015788	0	2	0	0	2
OG0015789	0	2	0	0	2
OG0015790	0	1	1	0	2
OG0015791	0	1	1	0	2
OG0015792	0	1	1	0	2
OG0015793	0	1	1	0	2
OG0015794	0	2	0	0	2
OG0015795	0	1	0	1	2
OG0015796	0	1	0	1	2
OG0015797	0	2	0	0	2
OG0015798	0	1	1	0	2
OG0015799	0	2	0	0	2
OG0015800	0	1	1	0	2
OG0015801	0	1	1	0	2
OG0015802	0	2	0	0	2
OG0015803	0	2	0	0	2
OG0015804	0	2	0	0	2
OG0015805	0	2	0	0	2
OG0015806	0	1	1	0	2
OG0015807	0	1	0	1	2
OG0015808	0	1	1	0	2
OG0015809	0	2	0	0	2
OG0015810	0	1	1	0	2
OG0015811	0	1	1	0	2
OG0015812	0	2	0	0	2
OG0015813	0	2	0	0	2
OG0015814	0	2	0	0	2
OG0015815	0	2	0	0	2
OG0015816	0	1	0	1	2
OG0015817	0	1	1	0	2
OG0015818	0	1	1	0	2
OG0015819	0	2	0	0	2
OG0015820	0	1	1	0	2
OG0015821	0	2	0	0	2
OG0015822	0	1	1	0	2
OG0015823	0	2	0	0	2
OG0015824	0	2	0	0	2
OG0015825	0	1	1	0	2
OG0015826	0	1	1	0	2
OG0015827	0	1	1	0	2
OG0015828	0	2	0	0	2
OG0015829	0	1	1	0	2
OG0015830	0	1	0	1	2
OG0015831	0	2	0	0	2
OG0015832	0	2	0	0	2
OG0015833	0	2	0	0	2
OG0015834	0	1	1	0	2
OG0015835	0	1	1	0	2
OG0015836	0	1	1	0	2
OG0015837	0	1	1	0	2
OG0015838	0	1	1	0	2
OG0015839	0	1	1	0	2
OG0015840	0	1	1	0	2
OG0015841	0	2	0	0	2
OG0015842	0	1	1	0	2
OG0015843	0	1	1	0	2
OG0015844	0	2	0	0	2
OG0015845	0	1	1	0	2
OG0015846	0	2	0	0	2
OG0015847	0	2	0	0	2
OG0015848	0	1	1	0	2
OG0015849	0	1	1	0	2
OG0015850	0	1	1	0	2
OG0015851	0	1	1	0	2
OG0015852	0	1	1	0	2
OG0015853	0	1	1	0	2
OG0015854	0	1	1	0	2
OG0015855	0	1	1	0	2
OG0015856	0	1	1	0	2
OG0015857	0	2	0	0	2
OG0015858	0	1	1	0	2
OG0015859	0	2	0	0	2
OG0015860	0	1	1	0	2
OG0015861	0	2	0	0	2
OG0015862	0	1	1	0	2
OG0015863	0	1	1	0	2
OG0015864	0	2	0	0	2
OG0015865	0	1	1	0	2
OG0015866	0	1	1	0	2
OG0015867	0	1	0	1	2
OG0015868	0	2	0	0	2
OG0015869	0	2	0	0	2
OG0015870	0	1	1	0	2
OG0015871	0	1	1	0	2
OG0015872	0	2	0	0	2
OG0015873	0	1	1	0	2
OG0015874	0	1	1	0	2
OG0015875	0	1	1	0	2
OG0015876	0	2	0	0	2
OG0015877	0	2	0	0	2
OG0015878	0	1	0	1	2
OG0015879	0	1	1	0	2
OG0015880	0	2	0	0	2
OG0015881	0	1	1	0	2
OG0015882	0	1	1	0	2
OG0015883	0	1	1	0	2
OG0015884	0	1	1	0	2
OG0015885	0	1	1	0	2
OG0015886	0	1	1	0	2
OG0015887	0	1	1	0	2
OG0015888	0	1	1	0	2
OG0015889	0	1	1	0	2
OG0015890	0	1	1	0	2
OG0015891	0	1	1	0	2
OG0015892	0	1	1	0	2
OG0015893	0	1	1	0	2
OG0015894	0	1	1	0	2
OG0015895	0	1	1	0	2
OG0015896	0	1	1	0	2
OG0015897	0	1	1	0	2
OG0015898	0	1	1	0	2
OG0015899	0	1	0	1	2
OG0015900	0	1	1	0	2
OG0015901	0	2	0	0	2
OG0015902	0	1	1	0	2
OG0015903	0	1	1	0	2
OG0015904	0	2	0	0	2
OG0015905	0	1	1	0	2
OG0015906	0	2	0	0	2
OG0015907	0	1	0	1	2
OG0015908	0	1	1	0	2
OG0015909	0	2	0	0	2
OG0015910	0	1	0	1	2
OG0015911	0	1	1	0	2
OG0015912	0	1	1	0	2
OG0015913	0	2	0	0	2
OG0015914	0	2	0	0	2
OG0015915	0	2	0	0	2
OG0015916	0	2	0	0	2
OG0015917	0	2	0	0	2
OG0015918	0	1	1	0	2
OG0015919	0	2	0	0	2
OG0015920	0	1	1	0	2
OG0015921	0	2	0	0	2
OG0015922	0	1	1	0	2
OG0015923	0	2	0	0	2
OG0015924	0	2	0	0	2
OG0015925	0	2	0	0	2
OG0015926	0	2	0	0	2
OG0015927	0	2	0	0	2
OG0015928	0	1	1	0	2
OG0015929	0	2	0	0	2
OG0015930	0	1	1	0	2
OG0015931	0	1	1	0	2
OG0015932	0	2	0	0	2
OG0015933	0	1	1	0	2
OG0015934	0	1	0	1	2
OG0015935	0	1	1	0	2
OG0015936	0	1	0	1	2
OG0015937	0	2	0	0	2
OG0015938	0	1	1	0	2
OG0015939	0	1	1	0	2
OG0015940	0	1	1	0	2
OG0015941	0	1	1	0	2
OG0015942	0	1	1	0	2
OG0015943	0	2	0	0	2
OG0015944	0	1	1	0	2
OG0015945	0	1	1	0	2
OG0015946	0	1	1	0	2
OG0015947	0	2	0	0	2
OG0015948	0	1	1	0	2
OG0015949	0	2	0	0	2
OG0015950	0	2	0	0	2
OG0015951	0	1	1	0	2
OG0015952	0	1	1	0	2
OG0015953	0	1	1	0	2
OG0015954	0	1	1	0	2
OG0015955	0	2	0	0	2
OG0015956	0	1	1	0	2
OG0015957	0	1	1	0	2
OG0015958	0	2	0	0	2
OG0015959	0	2	0	0	2
OG0015960	0	2	0	0	2
OG0015961	0	1	1	0	2
OG0015962	0	1	0	1	2
OG0015963	0	1	1	0	2
OG0015964	0	1	1	0	2
OG0015965	0	2	0	0	2
OG0015966	0	2	0	0	2
OG0015967	0	1	1	0	2
OG0015968	0	1	1	0	2
OG0015969	0	1	1	0	2
OG0015970	0	1	1	0	2
OG0015971	0	2	0	0	2
OG0015972	0	2	0	0	2
OG0015973	0	1	1	0	2
OG0015974	0	2	0	0	2
OG0015975	0	1	1	0	2
OG0015976	0	1	1	0	2
OG0015977	0	1	1	0	2
OG0015978	0	1	1	0	2
OG0015979	0	2	0	0	2
OG0015980	0	1	1	0	2
OG0015981	0	1	1	0	2
OG0015982	0	2	0	0	2
OG0015983	0	2	0	0	2
OG0015984	0	2	0	0	2
OG0015985	0	1	1	0	2
OG0015986	0	2	0	0	2
OG0015987	0	1	1	0	2
OG0015988	0	2	0	0	2
OG0015989	0	1	1	0	2
OG0015990	0	2	0	0	2
OG0015991	0	1	1	0	2
OG0015992	0	2	0	0	2
OG0015993	0	1	1	0	2
OG0015994	0	1	1	0	2
OG0015995	0	1	1	0	2
OG0015996	0	2	0	0	2
OG0015997	0	1	1	0	2
OG0015998	0	1	1	0	2
OG0015999	0	1	1	0	2
OG0016000	0	1	0	1	2
OG0016001	0	1	0	1	2
OG0016002	0	1	1	0	2
OG0016003	0	1	1	0	2
OG0016004	0	1	1	0	2
OG0016005	0	2	0	0	2
OG0016006	0	2	0	0	2
OG0016007	0	1	1	0	2
OG0016008	0	1	1	0	2
OG0016009	0	1	0	1	2
OG0016010	0	1	1	0	2
OG0016011	0	1	1	0	2
OG0016012	0	1	1	0	2
OG0016013	0	1	0	1	2
OG0016014	0	2	0	0	2
OG0016015	0	2	0	0	2
OG0016016	0	1	0	1	2
OG0016017	0	1	1	0	2
OG0016018	0	1	1	0	2
OG0016019	0	1	1	0	2
OG0016020	0	1	1	0	2
OG0016021	0	1	1	0	2
OG0016022	0	2	0	0	2
OG0016023	0	1	1	0	2
OG0016024	0	1	1	0	2
OG0016025	0	1	1	0	2
OG0016026	0	1	1	0	2
OG0016027	0	2	0	0	2
OG0016028	0	1	1	0	2
OG0016029	0	2	0	0	2
OG0016030	0	1	1	0	2
OG0016031	0	1	1	0	2
OG0016032	0	1	1	0	2
OG0016033	0	1	1	0	2
OG0016034	0	1	1	0	2
OG0016035	0	1	1	0	2
OG0016036	0	2	0	0	2
OG0016037	0	2	0	0	2
OG0016038	0	1	1	0	2
OG0016039	0	2	0	0	2
OG0016040	0	1	1	0	2
OG0016041	0	1	1	0	2
OG0016042	0	1	1	0	2
OG0016043	0	1	1	0	2
OG0016044	0	2	0	0	2
OG0016045	0	2	0	0	2
OG0016046	0	1	1	0	2
OG0016047	0	1	1	0	2
OG0016048	0	1	1	0	2
OG0016049	0	2	0	0	2
OG0016050	0	2	0	0	2
OG0016051	0	1	1	0	2
OG0016052	0	2	0	0	2
OG0016053	0	1	1	0	2
OG0016054	0	1	0	1	2
OG0016055	0	2	0	0	2
OG0016056	0	1	1	0	2
OG0016057	0	1	1	0	2
OG0016058	0	1	1	0	2
OG0016059	0	1	1	0	2
OG0016060	0	2	0	0	2
OG0016061	0	1	1	0	2
OG0016062	0	2	0	0	2
OG0016063	0	2	0	0	2
OG0016064	0	2	0	0	2
OG0016065	0	2	0	0	2
OG0016066	0	1	1	0	2
OG0016067	0	1	1	0	2
OG0016068	0	2	0	0	2
OG0016069	0	1	1	0	2
OG0016070	0	1	1	0	2
OG0016071	0	2	0	0	2
OG0016072	0	1	1	0	2
OG0016073	0	2	0	0	2
OG0016074	0	1	1	0	2
OG0016075	0	1	1	0	2
OG0016076	0	2	0	0	2
OG0016077	0	1	1	0	2
OG0016078	0	1	1	0	2
OG0016079	0	2	0	0	2
OG0016080	0	1	1	0	2
OG0016081	0	2	0	0	2
OG0016082	0	1	1	0	2
OG0016083	0	2	0	0	2
OG0016084	0	1	1	0	2
OG0016085	0	2	0	0	2
OG0016086	0	1	1	0	2
OG0016087	0	1	1	0	2
OG0016088	0	2	0	0	2
OG0016089	0	2	0	0	2
OG0016090	0	2	0	0	2
OG0016091	0	2	0	0	2
OG0016092	0	1	1	0	2
OG0016093	0	1	1	0	2
OG0016094	0	2	0	0	2
OG0016095	0	1	1	0	2
OG0016096	0	2	0	0	2
OG0016097	0	1	1	0	2
OG0016098	0	1	1	0	2
OG0016099	0	2	0	0	2
OG0016100	0	1	1	0	2
OG0016101	0	1	1	0	2
OG0016102	0	2	0	0	2
OG0016103	0	1	1	0	2
OG0016104	0	1	1	0	2
OG0016105	0	2	0	0	2
OG0016106	0	1	1	0	2
OG0016107	0	1	1	0	2
OG0016108	0	1	0	1	2
OG0016109	0	1	1	0	2
OG0016110	0	1	1	0	2
OG0016111	0	2	0	0	2
OG0016112	0	1	1	0	2
OG0016113	0	1	1	0	2
OG0016114	0	1	1	0	2
OG0016115	0	2	0	0	2
OG0016116	0	2	0	0	2
OG0016117	0	1	1	0	2
OG0016118	0	1	1	0	2
OG0016119	0	1	1	0	2
OG0016120	0	1	1	0	2
OG0016121	0	1	1	0	2
OG0016122	0	2	0	0	2
OG0016123	0	1	0	1	2
OG0016124	0	1	1	0	2
OG0016125	0	2	0	0	2
OG0016126	0	2	0	0	2
OG0016127	0	1	1	0	2
OG0016128	0	2	0	0	2
OG0016129	0	1	1	0	2
OG0016130	0	2	0	0	2
OG0016131	0	1	1	0	2
OG0016132	0	1	1	0	2
OG0016133	0	1	1	0	2
OG0016134	0	2	0	0	2
OG0016135	0	2	0	0	2
OG0016136	0	1	0	1	2
OG0016137	0	2	0	0	2
OG0016138	0	2	0	0	2
OG0016139	0	2	0	0	2
OG0016140	0	1	1	0	2
OG0016141	0	1	1	0	2
OG0016142	0	1	1	0	2
OG0016143	0	2	0	0	2
OG0016144	0	2	0	0	2
OG0016145	0	2	0	0	2
OG0016146	0	1	1	0	2
OG0016147	0	2	0	0	2
OG0016148	0	1	1	0	2
OG0016149	0	1	1	0	2
OG0016150	0	2	0	0	2
OG0016151	0	1	1	0	2
OG0016152	0	1	0	1	2
OG0016153	0	1	1	0	2
OG0016154	0	1	0	1	2
OG0016155	0	2	0	0	2
OG0016156	0	1	1	0	2
OG0016157	0	2	0	0	2
OG0016158	0	2	0	0	2
OG0016159	0	2	0	0	2
OG0016160	0	1	1	0	2
OG0016161	0	1	1	0	2
OG0016162	0	1	1	0	2
OG0016163	0	1	1	0	2
OG0016164	0	1	1	0	2
OG0016165	0	2	0	0	2
OG0016166	0	2	0	0	2
OG0016167	0	1	1	0	2
OG0016168	0	1	1	0	2
OG0016169	0	1	1	0	2
OG0016170	0	1	1	0	2
OG0016171	0	1	1	0	2
OG0016172	0	2	0	0	2
OG0016173	0	2	0	0	2
OG0016174	0	1	1	0	2
OG0016175	0	1	1	0	2
OG0016176	0	2	0	0	2
OG0016177	0	2	0	0	2
OG0016178	0	2	0	0	2
OG0016179	0	2	0	0	2
OG0016180	0	1	1	0	2
OG0016181	0	1	1	0	2
OG0016182	0	1	1	0	2
OG0016183	0	1	1	0	2
OG0016184	0	2	0	0	2
OG0016185	0	1	1	0	2
OG0016186	0	1	0	1	2
OG0016187	0	2	0	0	2
OG0016188	0	2	0	0	2
OG0016189	0	1	1	0	2
OG0016190	0	1	0	1	2
OG0016191	0	1	1	0	2
OG0016192	0	1	1	0	2
OG0016193	0	1	1	0	2
OG0016194	0	2	0	0	2
OG0016195	0	1	0	1	2
OG0016196	0	1	1	0	2
OG0016197	0	2	0	0	2
OG0016198	0	2	0	0	2
OG0016199	0	1	1	0	2
OG0016200	0	1	1	0	2
OG0016201	0	2	0	0	2
OG0016202	0	2	0	0	2
OG0016203	0	1	1	0	2
OG0016204	0	1	1	0	2
OG0016205	0	1	1	0	2
OG0016206	0	1	1	0	2
OG0016207	0	2	0	0	2
OG0016208	0	1	1	0	2
OG0016209	0	1	1	0	2
OG0016210	0	2	0	0	2
OG0016211	0	2	0	0	2
OG0016212	0	1	1	0	2
OG0016213	0	1	0	1	2
OG0016214	0	0	2	0	2
OG0016215	0	0	2	0	2
OG0016216	0	0	2	0	2
OG0016217	0	0	2	0	2
OG0016218	0	0	2	0	2
OG0016219	0	0	2	0	2
OG0016220	0	0	2	0	2
OG0016221	0	0	2	0	2
OG0016222	0	0	2	0	2
OG0016223	0	0	2	0	2
OG0016224	0	0	2	0	2
OG0016225	0	0	2	0	2
OG0016226	0	0	2	0	2
OG0016227	0	0	2	0	2
OG0016228	0	0	2	0	2
OG0016229	0	0	2	0	2
OG0016230	0	0	2	0	2
OG0016231	0	0	2	0	2
OG0016232	0	0	2	0	2
OG0016233	0	0	2	0	2
OG0016234	0	0	2	0	2
OG0016235	0	0	2	0	2
OG0016236	0	0	2	0	2
OG0016237	0	0	2	0	2
OG0016238	0	0	1	1	2
OG0016239	0	0	2	0	2
OG0016240	0	0	2	0	2
OG0016241	0	0	2	0	2
OG0016242	0	0	2	0	2
OG0016243	0	0	1	1	2
OG0016244	0	0	2	0	2
OG0016245	0	0	2	0	2
OG0016246	0	0	2	0	2
OG0016247	0	0	2	0	2
OG0016248	0	0	2	0	2
OG0016249	0	0	2	0	2
OG0016250	0	0	2	0	2
OG0016251	0	0	2	0	2
OG0016252	0	0	2	0	2
OG0016253	0	0	2	0	2
OG0016254	0	0	2	0	2
OG0016255	0	0	2	0	2
OG0016256	0	0	1	1	2
OG0016257	0	0	2	0	2
OG0016258	0	0	2	0	2
OG0016259	0	0	1	1	2
OG0016260	0	0	2	0	2
OG0016261	0	0	2	0	2
OG0016262	0	0	2	0	2
OG0016263	0	0	2	0	2
OG0016264	0	0	2	0	2
OG0016265	0	0	2	0	2
OG0016266	0	0	2	0	2
OG0016267	0	0	2	0	2
OG0016268	0	0	2	0	2
OG0016269	0	0	1	1	2
OG0016270	0	0	2	0	2
OG0016271	0	0	2	0	2
OG0016272	0	0	2	0	2
OG0016273	0	0	2	0	2
OG0016274	0	0	2	0	2
OG0016275	0	0	2	0	2
OG0016276	0	0	2	0	2
OG0016277	0	0	2	0	2
OG0016278	0	0	2	0	2
OG0016279	0	0	2	0	2
OG0016280	0	0	2	0	2
OG0016281	0	0	2	0	2
OG0016282	0	0	2	0	2
OG0016283	0	0	2	0	2
OG0016284	0	0	1	1	2
OG0016285	0	0	2	0	2
OG0016286	0	0	2	0	2
OG0016287	0	0	2	0	2
OG0016288	0	0	2	0	2
OG0016289	0	0	2	0	2
OG0016290	0	0	1	1	2
OG0016291	0	0	2	0	2
OG0016292	0	0	2	0	2
OG0016293	0	0	1	1	2
OG0016294	0	0	2	0	2
OG0016295	0	0	2	0	2
OG0016296	0	0	2	0	2
OG0016297	0	0	2	0	2
OG0016298	0	0	2	0	2
OG0016299	0	0	2	0	2
OG0016300	0	0	2	0	2
OG0016301	0	0	1	1	2
OG0016302	0	0	2	0	2
OG0016303	0	0	2	0	2
OG0016304	0	0	1	1	2
OG0016305	0	0	2	0	2
OG0016306	0	0	2	0	2
OG0016307	0	0	2	0	2
OG0016308	0	0	2	0	2
OG0016309	0	0	2	0	2
OG0016310	0	0	2	0	2
OG0016311	0	0	2	0	2
OG0016312	0	0	2	0	2
OG0016313	0	0	2	0	2
OG0016314	0	0	2	0	2
OG0016315	0	0	2	0	2
OG0016316	0	0	2	0	2
OG0016317	0	0	2	0	2
OG0016318	0	0	1	1	2
OG0016319	0	0	2	0	2
OG0016320	0	0	2	0	2
OG0016321	0	0	2	0	2
OG0016322	0	0	2	0	2
OG0016323	0	0	2	0	2
OG0016324	0	0	2	0	2
OG0016325	0	0	2	0	2
OG0016326	0	0	2	0	2
OG0016327	0	0	2	0	2
OG0016328	0	0	2	0	2
OG0016329	0	0	2	0	2
OG0016330	0	0	1	1	2
OG0016331	0	0	2	0	2
OG0016332	0	0	2	0	2
OG0016333	0	0	2	0	2
OG0016334	0	0	2	0	2
OG0016335	0	0	2	0	2
OG0016336	0	0	2	0	2
OG0016337	0	0	2	0	2
OG0016338	0	0	2	0	2
OG0016339	0	0	2	0	2
OG0016340	0	0	2	0	2
OG0016341	0	0	2	0	2
OG0016342	0	0	2	0	2
OG0016343	0	0	2	0	2
OG0016344	0	0	1	1	2
OG0016345	0	0	2	0	2
OG0016346	0	0	2	0	2
OG0016347	0	0	2	0	2
OG0016348	0	0	2	0	2
OG0016349	0	0	2	0	2
OG0016350	0	0	2	0	2
OG0016351	0	0	1	1	2
OG0016352	0	0	2	0	2
OG0016353	0	0	2	0	2
OG0016354	0	0	2	0	2
OG0016355	0	0	2	0	2
OG0016356	0	0	2	0	2
OG0016357	0	0	2	0	2
OG0016358	0	0	2	0	2
OG0016359	0	0	2	0	2
OG0016360	0	0	2	0	2
OG0016361	0	0	2	0	2
OG0016362	0	0	2	0	2
OG0016363	0	0	2	0	2
OG0016364	0	0	2	0	2
OG0016365	0	0	2	0	2
OG0016366	0	0	2	0	2
OG0016367	0	0	2	0	2
OG0016368	0	0	2	0	2
OG0016369	0	0	2	0	2
OG0016370	0	0	2	0	2
OG0016371	0	0	2	0	2
OG0016372	0	0	2	0	2
OG0016373	0	0	2	0	2
OG0016374	0	0	2	0	2
OG0016375	0	0	2	0	2
OG0016376	0	0	2	0	2
OG0016377	0	0	2	0	2
OG0016378	0	0	2	0	2
OG0016379	0	0	2	0	2
OG0016380	0	0	1	1	2
OG0016381	0	0	2	0	2
OG0016382	0	0	2	0	2
OG0016383	0	0	2	0	2
OG0016384	0	0	1	1	2
OG0016385	0	0	2	0	2
OG0016386	0	0	2	0	2
OG0016387	0	0	2	0	2
OG0016388	0	0	2	0	2
OG0016389	0	0	2	0	2
OG0016390	0	0	2	0	2
OG0016391	0	0	2	0	2
OG0016392	0	0	2	0	2
OG0016393	0	0	2	0	2
OG0016394	0	0	2	0	2
OG0016395	0	0	2	0	2
OG0016396	0	0	2	0	2
OG0016397	0	0	2	0	2
OG0016398	0	0	1	1	2
OG0016399	0	0	2	0	2
OG0016400	0	0	2	0	2
OG0016401	0	0	2	0	2
OG0016402	0	0	2	0	2
OG0016403	0	0	2	0	2
OG0016404	0	0	1	1	2
OG0016405	0	0	2	0	2
OG0016406	0	0	2	0	2
OG0016407	0	0	2	0	2
OG0016408	0	0	2	0	2
OG0016409	0	0	2	0	2
OG0016410	0	0	1	1	2
OG0016411	0	0	2	0	2
OG0016412	0	0	2	0	2
OG0016413	0	0	1	1	2
OG0016414	0	0	1	1	2
OG0016415	0	0	2	0	2
OG0016416	0	0	1	1	2
OG0016417	0	0	2	0	2
OG0016418	0	0	2	0	2
OG0016419	0	0	1	1	2
OG0016420	0	0	2	0	2
OG0016421	0	0	2	0	2
OG0016422	0	0	2	0	2
OG0016423	0	0	1	1	2
OG0016424	0	0	2	0	2
OG0016425	0	0	2	0	2
OG0016426	0	0	2	0	2
OG0016427	0	0	1	1	2
OG0016428	0	0	1	1	2
OG0016429	0	0	1	1	2
OG0016430	0	0	2	0	2
OG0016431	0	0	1	1	2
OG0016432	0	0	2	0	2
OG0016433	0	0	2	0	2
OG0016434	0	0	2	0	2
OG0016435	0	0	2	0	2
OG0016436	0	0	2	0	2
OG0016437	0	0	2	0	2
OG0016438	0	0	2	0	2
OG0016439	0	0	2	0	2
OG0016440	0	0	2	0	2
OG0016441	0	0	2	0	2
OG0016442	0	0	1	1	2
OG0016443	0	0	2	0	2
OG0016444	0	0	2	0	2
OG0016445	0	0	2	0	2
OG0016446	0	0	2	0	2
OG0016447	0	0	2	0	2
OG0016448	0	0	2	0	2
OG0016449	0	0	2	0	2
OG0016450	0	0	2	0	2
OG0016451	0	0	2	0	2
OG0016452	0	0	2	0	2
OG0016453	0	0	2	0	2
OG0016454	0	0	1	1	2
OG0016455	0	0	2	0	2
OG0016456	0	0	1	1	2
OG0016457	0	0	2	0	2
OG0016458	0	0	1	1	2
OG0016459	0	0	2	0	2
OG0016460	0	0	2	0	2
OG0016461	0	0	2	0	2
OG0016462	0	0	1	1	2
OG0016463	0	0	2	0	2
OG0016464	0	0	2	0	2
OG0016465	0	0	2	0	2
OG0016466	0	0	2	0	2
OG0016467	0	0	1	1	2
OG0016468	0	0	2	0	2
OG0016469	0	0	1	1	2
OG0016470	0	0	2	0	2
OG0016471	0	0	2	0	2
OG0016472	0	0	2	0	2
OG0016473	0	0	2	0	2
OG0016474	0	0	2	0	2
OG0016475	0	0	2	0	2
OG0016476	0	0	2	0	2
OG0016477	0	0	2	0	2
OG0016478	0	0	1	1	2
OG0016479	0	0	1	1	2
OG0016480	0	0	1	1	2
OG0016481	0	0	2	0	2
OG0016482	0	0	2	0	2
OG0016483	0	0	2	0	2
OG0016484	0	0	2	0	2
OG0016485	0	0	2	0	2
OG0016486	0	0	2	0	2
OG0016487	0	0	1	1	2
OG0016488	0	0	2	0	2
OG0016489	0	0	2	0	2
OG0016490	0	0	2	0	2
OG0016491	0	0	2	0	2
OG0016492	0	0	2	0	2
OG0016493	0	0	2	0	2
OG0016494	0	0	2	0	2
OG0016495	0	0	2	0	2
OG0016496	0	0	2	0	2
OG0016497	0	0	2	0	2
OG0016498	0	0	1	1	2
OG0016499	0	0	2	0	2
OG0016500	0	0	2	0	2
OG0016501	0	0	2	0	2
OG0016502	0	0	2	0	2
OG0016503	0	0	2	0	2
OG0016504	0	0	2	0	2
OG0016505	0	0	2	0	2
OG0016506	0	0	2	0	2
OG0016507	0	0	2	0	2
OG0016508	0	0	2	0	2
OG0016509	0	0	2	0	2
OG0016510	0	0	2	0	2
OG0016511	0	0	2	0	2
OG0016512	0	0	2	0	2
OG0016513	0	0	2	0	2
OG0016514	0	0	2	0	2
OG0016515	0	0	2	0	2
OG0016516	0	0	2	0	2
OG0016517	0	0	2	0	2
OG0016518	0	0	1	1	2
OG0016519	0	0	2	0	2
OG0016520	0	0	2	0	2
OG0016521	0	0	2	0	2
OG0016522	0	0	2	0	2
OG0016523	0	0	2	0	2
OG0016524	0	0	2	0	2
OG0016525	0	0	1	1	2
OG0016526	0	0	2	0	2
OG0016527	0	0	2	0	2
OG0016528	0	0	2	0	2
OG0016529	0	0	1	1	2
OG0016530	0	0	2	0	2
OG0016531	0	0	2	0	2
OG0016532	0	0	2	0	2
OG0016533	0	0	2	0	2
OG0016534	0	0	1	1	2
OG0016535	0	0	1	1	2
OG0016536	0	0	1	1	2
OG0016537	0	0	2	0	2
OG0016538	0	0	2	0	2
OG0016539	0	0	2	0	2
OG0016540	0	0	2	0	2
OG0016541	0	0	2	0	2
OG0016542	0	0	2	0	2
OG0016543	0	0	2	0	2
OG0016544	0	0	2	0	2
OG0016545	0	0	2	0	2
OG0016546	0	0	2	0	2
OG0016547	0	0	1	1	2
OG0016548	0	0	2	0	2
OG0016549	0	0	1	1	2
OG0016550	0	0	2	0	2
OG0016551	0	0	2	0	2
OG0016552	0	0	1	1	2
OG0016553	0	0	2	0	2
OG0016554	0	0	1	1	2
OG0016555	0	0	2	0	2
OG0016556	0	0	2	0	2
OG0016557	0	0	2	0	2
OG0016558	0	0	2	0	2
OG0016559	0	0	2	0	2
OG0016560	0	0	2	0	2
OG0016561	0	0	2	0	2
OG0016562	0	0	2	0	2
OG0016563	0	0	1	1	2
OG0016564	0	0	2	0	2
OG0016565	0	0	2	0	2
OG0016566	0	0	2	0	2
OG0016567	0	0	2	0	2
OG0016568	0	0	2	0	2
OG0016569	0	0	2	0	2
OG0016570	0	0	2	0	2
OG0016571	0	0	1	1	2
OG0016572	0	0	2	0	2
OG0016573	0	0	2	0	2
OG0016574	0	0	2	0	2
OG0016575	0	0	2	0	2
OG0016576	0	0	2	0	2
OG0016577	0	0	2	0	2
OG0016578	0	0	1	1	2
OG0016579	0	0	2	0	2
OG0016580	0	0	2	0	2
OG0016581	0	0	2	0	2
OG0016582	0	0	2	0	2
OG0016583	0	0	2	0	2
OG0016584	0	0	2	0	2
OG0016585	0	0	2	0	2
OG0016586	0	0	2	0	2
OG0016587	0	0	2	0	2
OG0016588	0	0	2	0	2
OG0016589	0	0	2	0	2
OG0016590	0	0	2	0	2
OG0016591	0	0	2	0	2
OG0016592	0	0	1	1	2
OG0016593	0	0	2	0	2
OG0016594	0	0	2	0	2
OG0016595	0	0	2	0	2
OG0016596	0	0	2	0	2
OG0016597	0	0	2	0	2
OG0016598	0	0	2	0	2
OG0016599	0	0	2	0	2
OG0016600	0	0	2	0	2
OG0016601	0	0	2	0	2
OG0016602	0	0	2	0	2
OG0016603	0	0	2	0	2
OG0016604	0	0	2	0	2
OG0016605	0	0	2	0	2
OG0016606	0	0	2	0	2
OG0016607	0	0	2	0	2
OG0016608	0	0	2	0	2
OG0016609	0	0	2	0	2
OG0016610	0	0	1	1	2
OG0016611	0	0	2	0	2
OG0016612	0	0	2	0	2
OG0016613	0	0	2	0	2
OG0016614	0	0	2	0	2
OG0016615	0	0	2	0	2
OG0016616	0	0	2	0	2
OG0016617	0	0	2	0	2
OG0016618	0	0	2	0	2
OG0016619	0	0	2	0	2
OG0016620	0	0	1	1	2
OG0016621	0	0	2	0	2
OG0016622	0	0	2	0	2
OG0016623	0	0	1	1	2
OG0016624	0	0	2	0	2
OG0016625	0	0	2	0	2
OG0016626	0	0	2	0	2
OG0016627	0	0	2	0	2
OG0016628	0	0	2	0	2
OG0016629	0	0	2	0	2
OG0016630	0	0	2	0	2
OG0016631	0	0	1	1	2
OG0016632	0	0	2	0	2
OG0016633	0	0	2	0	2
OG0016634	0	0	2	0	2
OG0016635	0	0	1	1	2
OG0016636	0	0	2	0	2
OG0016637	0	0	2	0	2
OG0016638	0	0	2	0	2
OG0016639	0	0	1	1	2
OG0016640	0	0	1	1	2
OG0016641	0	0	2	0	2
OG0016642	0	0	1	1	2
OG0016643	0	0	2	0	2
OG0016644	0	0	2	0	2
OG0016645	0	0	2	0	2
OG0016646	0	0	2	0	2
OG0016647	0	0	1	1	2
OG0016648	0	0	1	1	2
OG0016649	0	0	1	1	2
OG0016650	0	0	1	1	2
OG0016651	0	0	0	2	2
OG0016652	0	0	0	2	2
OG0016653	0	0	0	2	2
OG0016654	0	0	0	2	2
OG0016655	0	0	0	2	2
OG0016656	0	0	0	2	2
OG0016657	0	0	0	2	2
OG0016658	0	0	0	2	2
OG0016659	0	0	0	2	2
OG0016660	0	0	0	2	2
OG0016661	0	0	0	2	2
OG0016662	0	0	0	2	2
OG0016663	0	0	0	2	2
OG0016664	0	0	0	2	2
OG0016665	0	0	0	2	2
OG0016666	0	0	0	2	2
OG0016667	0	0	0	2	2
OG0016668	0	0	0	2	2
OG0016669	0	0	0	2	2
OG0016670	0	0	0	2	2
OG0016671	0	0	0	2	2
OG0016672	0	0	0	2	2
OG0016673	0	0	0	2	2
OG0016674	0	0	0	2	2
OG0016675	0	0	0	2	2
OG0016676	0	0	0	2	2
OG0016677	0	0	0	2	2
OG0016678	0	0	0	2	2
OG0016679	0	0	0	2	2
OG0016680	0	0	0	2	2
OG0016681	0	0	0	2	2
OG0016682	0	0	0	2	2
OG0016683	0	0	0	2	2
OG0016684	0	0	0	2	2
OG0016685	0	0	0	2	2
OG0016686	0	0	0	2	2
OG0016687	0	0	0	2	2
OG0016688	0	0	0	2	2
OG0016689	0	0	0	2	2
OG0016690	0	0	0	2	2
OG0016691	0	0	0	2	2
OG0016692	0	0	0	2	2
OG0016693	0	0	0	2	2
OG0016694	0	0	0	2	2
OG0016695	0	0	0	2	2
OG0016696	0	0	0	2	2
OG0016697	0	0	0	2	2
OG0016698	0	0	0	2	2
OG0016699	0	0	0	2	2
OG0016700	0	0	0	2	2
OG0016701	0	0	0	2	2
OG0016702	0	0	0	2	2
OG0016703	0	0	0	2	2
OG0016704	0	0	0	2	2
OG0016705	0	0	0	2	2
OG0016706	0	0	0	2	2
OG0016707	0	0	0	2	2
OG0016708	0	0	0	2	2
OG0016709	0	0	0	2	2
OG0016710	0	0	0	2	2
OG0016711	0	0	0	2	2
OG0016712	0	0	0	2	2
OG0016713	0	0	0	2	2
OG0016714	0	0	0	2	2
OG0016715	0	0	0	2	2
OG0016716	0	0	0	2	2
OG0016717	0	0	0	2	2
OG0016718	0	0	0	2	2
OG0016719	0	0	0	2	2
OG0016720	0	0	0	2	2
OG0016721	0	0	0	2	2
OG0016722	0	0	0	2	2
OG0016723	0	0	0	2	2
OG0016724	0	0	0	2	2
OG0016725	0	0	0	2	2
OG0016726	0	0	0	2	2
OG0016727	0	0	0	2	2
OG0016728	0	0	0	2	2
OG0016729	0	0	0	2	2
OG0016730	0	0	0	2	2
OG0016731	0	0	0	2	2
OG0016732	0	0	0	2	2
OG0016733	0	0	0	2	2
OG0016734	0	0	0	2	2
OG0016735	0	0	0	2	2
OG0016736	0	0	0	2	2
OG0016737	0	0	0	2	2
OG0016738	0	0	0	2	2
OG0016739	0	0	0	2	2
OG0016740	0	0	0	2	2
OG0016741	0	0	0	2	2
OG0016742	0	0	0	2	2
OG0016743	0	0	0	2	2
OG0016744	0	0	0	2	2
OG0016745	0	0	0	2	2
OG0016746	0	0	0	2	2
OG0016747	0	0	0	2	2
OG0016748	0	0	0	2	2
OG0016749	0	0	0	2	2
OG0016750	0	0	0	2	2
OG0016751	0	0	0	2	2
OG0016752	0	0	0	2	2
OG0016753	0	0	0	2	2
OG0016754	0	0	0	2	2
OG0016755	0	0	0	2	2
OG0016756	0	0	0	2	2
OG0016757	0	0	0	2	2
OG0016758	0	0	0	2	2
OG0016759	0	0	0	2	2
OG0016760	0	0	0	2	2
OG0016761	0	0	0	2	2
OG0016762	0	0	0	2	2
OG0016763	0	0	0	2	2
OG0016764	0	0	0	2	2
OG0016765	0	0	0	2	2
OG0016766	0	0	0	2	2
OG0016767	0	0	0	2	2
OG0016768	0	0	0	2	2
OG0016769	0	0	0	2	2
OG0016770	0	0	0	2	2
OG0016771	0	0	0	2	2
OG0016772	0	0	0	2	2
OG0016773	0	0	0	2	2
OG0016774	0	0	0	2	2
OG0016775	0	0	0	2	2
OG0016776	0	0	0	2	2
OG0016777	0	0	0	2	2
OG0016778	0	0	0	2	2
OG0016779	0	0	0	2	2
OG0016780	0	0	0	2	2
OG0016781	0	0	0	2	2
OG0016782	0	0	0	2	2
OG0016783	0	0	0	2	2
OG0016784	0	0	0	2	2
OG0016785	0	0	0	2	2
OG0016786	0	0	0	2	2
OG0016787	0	0	0	2	2
OG0016788	0	0	0	2	2
OG0016789	0	0	0	2	2
OG0016790	0	0	0	2	2
OG0016791	0	0	0	2	2
OG0016792	0	0	0	2	2
OG0016793	0	0	0	2	2
OG0016794	0	0	0	2	2
OG0016795	0	0	0	2	2
OG0016796	0	0	0	2	2
OG0016797	0	0	0	2	2
OG0016798	0	0	0	2	2
OG0016799	0	0	0	2	2
OG0016800	0	0	0	2	2
OG0016801	0	0	0	2	2
OG0016802	0	0	0	2	2
OG0016803	0	0	0	2	2
OG0016804	0	0	0	2	2
OG0016805	0	0	0	2	2
OG0016806	0	0	0	2	2
OG0016807	0	0	0	2	2
OG0016808	0	0	0	2	2
OG0016809	0	0	0	2	2
OG0016810	0	0	0	2	2
OG0016811	0	0	0	2	2
OG0016812	0	0	0	2	2
OG0016813	0	0	0	2	2
OG0016814	0	0	0	2	2
OG0016815	0	0	0	2	2
OG0016816	0	0	0	2	2
OG0016817	0	0	0	2	2
OG0016818	0	0	0	2	2
OG0016819	0	0	0	2	2
OG0016820	0	0	0	2	2
OG0016821	0	0	0	2	2
OG0016822	0	0	0	2	2
OG0016823	0	0	0	2	2
OG0016824	0	0	0	2	2
OG0016825	0	0	0	2	2
OG0016826	0	0	0	2	2
OG0016827	0	0	0	2	2
OG0016828	0	0	0	2	2
OG0016829	0	0	0	2	2
OG0016830	0	0	0	2	2
OG0016831	0	0	0	2	2
OG0016832	0	0	0	2	2
OG0016833	0	0	0	2	2
OG0016834	0	0	0	2	2
OG0016835	0	0	0	2	2
OG0016836	0	0	0	2	2
OG0016837	0	0	0	2	2
OG0016838	0	0	0	2	2
OG0016839	0	0	0	2	2
OG0016840	0	0	0	2	2
OG0016841	0	0	0	2	2
OG0016842	0	0	0	2	2
OG0016843	0	0	0	2	2
OG0016844	0	0	0	2	2
OG0016845	0	0	0	2	2
OG0016846	0	0	0	2	2
OG0016847	0	0	0	2	2
OG0016848	0	0	0	2	2
OG0016849	0	0	0	2	2
OG0016850	0	0	0	2	2
OG0016851	0	0	0	2	2
OG0016852	0	0	0	2	2
OG0016853	0	0	0	2	2
OG0016854	0	0	0	2	2
OG0016855	0	0	0	2	2
OG0016856	0	0	0	2	2
OG0016857	0	0	0	2	2
OG0016858	0	0	0	2	2
OG0016859	0	0	0	2	2
OG0016860	0	0	0	2	2
OG0016861	0	0	0	2	2
OG0016862	0	0	0	2	2
OG0016863	0	0	0	2	2
OG0016864	0	0	0	2	2
OG0016865	0	0	0	2	2
OG0016866	0	0	0	2	2
OG0016867	0	0	0	2	2
OG0016868	0	0	0	2	2
OG0016869	0	0	0	2	2
OG0016870	0	0	0	2	2
OG0016871	0	0	0	2	2
OG0016872	0	0	0	2	2
OG0016873	0	0	0	2	2
OG0016874	0	0	0	2	2
OG0016875	0	0	0	2	2
OG0016876	0	0	0	2	2
OG0016877	0	0	0	2	2
OG0016878	0	0	0	2	2
OG0016879	0	0	0	2	2
OG0016880	0	0	0	2	2
OG0016881	0	0	0	2	2
OG0016882	0	0	0	2	2
OG0016883	0	0	0	2	2
OG0016884	0	0	0	2	2
OG0016885	0	0	0	2	2
OG0016886	0	0	0	2	2
OG0016887	0	0	0	2	2
OG0016888	0	0	0	2	2
OG0016889	0	0	0	2	2
OG0016890	0	0	0	2	2
OG0016891	0	0	0	2	2
OG0016892	0	0	0	2	2
OG0016893	0	0	0	2	2
OG0016894	0	0	0	2	2
OG0016895	0	0	0	2	2
OG0016896	0	0	0	2	2
OG0016897	0	0	0	2	2
OG0016898	0	0	0	2	2
OG0016899	0	0	0	2	2
OG0016900	0	0	0	2	2
OG0016901	0	0	0	2	2
OG0016902	0	0	0	2	2
OG0016903	0	0	0	2	2
OG0016904	0	0	0	2	2
OG0016905	0	0	0	2	2
OG0016906	0	0	0	2	2
OG0016907	0	0	0	2	2
OG0016908	0	0	0	2	2
OG0016909	0	0	0	2	2
OG0016910	0	0	0	2	2
OG0016911	0	0	0	2	2
OG0016912	0	0	0	2	2
OG0016913	0	0	0	2	2
OG0016914	0	0	0	2	2
OG0016915	0	0	0	2	2
OG0016916	0	0	0	2	2
OG0016917	0	0	0	2	2
OG0016918	0	0	0	2	2
OG0016919	0	0	0	2	2
OG0016920	0	0	0	2	2
OG0016921	0	0	0	2	2
OG0016922	0	0	0	2	2
OG0016923	0	0	0	2	2
OG0016924	0	0	0	2	2
OG0016925	0	0	0	2	2
OG0016926	0	0	0	2	2
OG0016927	0	0	0	2	2
OG0016928	0	0	0	2	2
OG0016929	0	0	0	2	2
OG0016930	0	0	0	2	2
OG0016931	0	0	0	2	2
OG0016932	0	0	0	2	2
OG0016933	0	0	0	2	2
OG0016934	0	0	0	2	2
OG0016935	0	0	0	2	2
OG0016936	0	0	0	2	2
OG0016937	0	0	0	2	2
OG0016938	0	0	0	2	2
OG0016939	0	0	0	2	2
OG0016940	0	0	0	2	2
OG0016941	0	0	0	2	2
OG0016942	0	0	0	2	2
OG0016943	0	0	0	2	2
OG0016944	0	0	0	2	2
OG0016945	0	0	0	2	2
OG0016946	0	0	0	2	2
OG0016947	0	0	0	2	2
OG0016948	0	0	0	2	2
OG0016949	0	0	0	2	2
OG0016950	0	0	0	2	2
OG0016951	0	0	0	2	2
OG0016952	0	0	0	2	2
OG0016953	0	0	0	2	2
OG0016954	0	0	0	2	2
OG0016955	0	0	0	2	2
OG0016956	0	0	0	2	2
OG0016957	0	0	0	2	2
OG0016958	0	0	0	2	2
OG0016959	0	0	0	2	2
OG0016960	0	0	0	2	2
OG0016961	0	0	0	2	2
OG0016962	0	0	0	2	2
OG0016963	0	0	0	2	2
OG0016964	0	0	0	2	2
OG0016965	0	0	0	2	2
OG0016966	0	0	0	2	2
OG0016967	0	0	0	2	2
OG0016968	0	0	0	2	2
OG0016969	0	0	0	2	2
OG0016970	0	0	0	2	2
OG0016971	0	0	0	2	2
OG0016972	0	0	0	2	2
OG0016973	0	0	0	2	2
OG0016974	0	0	0	2	2
OG0016975	0	0	0	2	2
OG0016976	0	0	0	2	2
OG0016977	0	0	0	2	2
OG0016978	0	0	0	2	2
OG0016979	0	0	0	2	2
OG0016980	0	0	0	2	2
OG0016981	0	0	0	2	2
OG0016982	0	0	0	2	2
OG0016983	0	0	0	2	2
OG0016984	0	0	0	2	2
OG0016985	0	0	0	2	2
OG0016986	0	0	0	2	2
OG0016987	0	0	0	2	2
OG0016988	0	0	0	2	2
OG0016989	0	0	0	2	2
OG0016990	0	0	0	2	2
OG0016991	0	0	0	2	2
OG0016992	0	0	0	2	2
OG0016993	0	0	0	2	2
OG0016994	0	0	0	2	2
OG0016995	0	0	0	2	2
OG0016996	0	0	0	2	2
OG0016997	0	0	0	2	2
OG0016998	0	0	0	2	2
OG0016999	0	0	0	2	2
OG0017000	0	0	0	2	2
OG0017001	0	0	0	2	2
OG0017002	0	0	0	2	2
OG0017003	0	0	0	2	2
OG0017004	0	0	0	2	2
OG0017005	0	0	0	2	2
OG0017006	0	0	0	2	2
OG0017007	0	0	0	2	2
OG0017008	0	0	0	2	2
OG0017009	0	0	0	2	2
OG0017010	0	0	0	2	2
OG0017011	0	0	0	2	2
OG0017012	0	0	0	2	2
OG0017013	0	0	0	2	2
OG0017014	0	0	0	2	2
OG0017015	0	0	0	2	2
OG0017016	0	0	0	2	2
OG0017017	0	0	0	2	2
OG0017018	0	0	0	2	2
OG0017019	0	0	0	2	2
OG0017020	0	0	0	2	2
OG0017021	0	0	0	2	2
OG0017022	0	0	0	2	2
OG0017023	0	0	0	2	2
OG0017024	0	0	0	2	2
OG0017025	0	0	0	2	2
OG0017026	0	0	0	2	2
OG0017027	0	0	0	2	2
OG0017028	0	0	0	2	2
OG0017029	0	0	0	2	2
OG0017030	0	0	0	2	2
OG0017031	0	0	0	2	2
OG0017032	0	0	0	2	2
OG0017033	0	0	0	2	2
OG0017034	0	0	0	2	2
OG0017035	0	0	0	2	2
OG0017036	0	0	0	2	2
OG0017037	0	0	0	2	2
OG0017038	0	0	0	2	2
OG0017039	0	0	0	2	2
OG0017040	0	0	0	2	2
OG0017041	0	0	0	2	2
OG0017042	0	0	0	2	2
OG0017043	0	0	0	2	2
OG0017044	0	0	0	2	2
OG0017045	0	0	0	2	2
OG0017046	0	0	0	2	2
OG0017047	0	0	0	2	2
OG0017048	0	0	0	2	2
OG0017049	0	0	0	2	2
OG0017050	0	0	0	2	2
OG0017051	0	0	0	2	2
OG0017052	0	0	0	2	2
OG0017053	0	0	0	2	2
OG0017054	0	0	0	2	2
OG0017055	0	0	0	2	2
OG0017056	0	0	0	2	2
OG0017057	0	0	0	2	2
OG0017058	0	0	0	2	2
OG0017059	0	0	0	2	2
OG0017060	0	0	0	2	2
OG0017061	0	0	0	2	2
OG0017062	0	0	0	2	2
OG0017063	0	0	0	2	2
OG0017064	0	0	0	2	2
OG0017065	0	0	0	2	2
OG0017066	0	0	0	2	2
OG0017067	0	0	0	2	2
OG0017068	0	0	0	2	2
OG0017069	0	0	0	2	2
OG0017070	0	0	0	2	2
OG0017071	0	0	0	2	2
OG0017072	0	0	0	2	2
OG0017073	0	0	0	2	2
OG0017074	0	0	0	2	2
OG0017075	0	0	0	2	2
OG0017076	0	0	0	2	2
OG0017077	0	0	0	2	2
OG0017078	0	0	0	2	2
OG0017079	0	0	0	2	2
OG0017080	0	0	0	2	2
OG0017081	0	0	0	2	2
OG0017082	0	0	0	2	2
OG0017083	0	0	0	2	2
OG0017084	0	0	0	2	2
OG0017085	0	0	0	2	2
OG0017086	0	0	0	2	2
OG0017087	0	0	0	2	2
OG0017088	0	0	0	2	2
OG0017089	0	0	0	2	2
OG0017090	0	0	0	2	2
OG0017091	0	0	0	2	2
OG0017092	0	0	0	2	2
OG0017093	0	0	0	2	2
OG0017094	0	0	0	2	2
OG0017095	0	0	0	2	2
OG0017096	0	0	0	2	2
OG0017097	0	0	0	2	2
OG0017098	0	0	0	2	2
OG0017099	0	0	0	2	2
OG0017100	0	0	0	2	2
OG0017101	0	0	0	2	2
OG0017102	0	0	0	2	2
OG0017103	0	0	0	2	2
OG0017104	0	0	0	2	2
OG0017105	0	0	0	2	2
OG0017106	0	0	0	2	2
OG0017107	0	0	0	2	2
OG0017108	0	0	0	2	2
OG0017109	0	0	0	2	2
OG0017110	0	0	0	2	2
OG0017111	0	0	0	2	2
OG0017112	0	0	0	2	2
OG0017113	0	0	0	2	2
OG0017114	0	0	0	2	2
